Anuncie::Advertise
su::its
producto::product
o::or
marca::brand
aquí::here
contáctenos::contact us
www.OpenSubtitles.org::www.opensubtitles.org
hoy::currently
Ves::You see
cómo::how
se::be
hace::ago
Si::If
creo::i think
que::may
ya::already
entendí::i understood
Mejor::Better
así::like this
sea::be
El::The
jefe::boss
me::me
corta::short
la::it
cabeza::head
si::if
estropeas::do you spoil
estas::these
muestras::samples
No::Not
te::do you
preocupes::worry
Estamos::Are
a::at
metros::meters
Dejaste::You left
usar::use
el::the
taladro::drill
Sí::Yes.
puede::can
manejar::manage
lo::it
Yo::Me
no::not
hice::i did
nada::nothing
Dame::Give me
mano::hand
Suelta::Loose
Olvídalo::Forget it
es::is
demasiado::excessively
tarde::afternoon
lograrás::will you achieve
Te::Te
tengo::i have
Qué::How
estabas::were you
pensando::thinking
está::is
pasando::passing
Toda::All
plataforma::deck
separando::separating
eso::it
pasa::passes
Lo::It
descubrimos::we discovered
fue::was
un::an
cambio::change
climático::climatic
Cataclismo::Cataclysm
ocurrió::it happened
mil::grand
años::age
La::It
concentración::concentration
de::of
estos::these
gases::gases
invernadero::greenhouse
en::in
hielo::ice
Indica::Indicate
calentamiento::heating
llevó::led
al::al
planeta::planet
A::AT
periodo::period
glaciar::glacier
duró::lasted
siglos::centuries
Estoy::I'm
confundido::confused
Pensé::I thought
hablábamos::we were talking
sobre::on
congelamiento::frostbite
una::an
paradoja::paradox
pero::but
global::global
producir::generate
enfriamiento::cooling
Déjenme::Let me
explicar::explain
les::les
hemisferio::hemisphere
norte::north
templado::lukewarm
debido::due
corriente::current
del::of the
atlántico::Atlantic
calor::heat
sol::Sun
llega::arrives
ecuador::equator
y::and
océano::ocean
lleva::carries
Pero::But
derritiendo::melting
los::the
polos::poles
alterando::altering
este::east
flujo::flow
Eventualmente::Eventually
terminará::will end
cuando::as
suceda::happen
clima::climate
Disculpe::Excuse me.
cuándo::when
cree::Cree
pueda::can
suceder::happen
profesor::professor
sé::i know
tal::such
vez::time
cien::hundred
quizás::perhaps
actuamos::we act
pronto::soon
Serán::They will be
nuestros::our
hijos::children
nietos::grandchildren
quienes::who
pagarán::will pay
precio::price
Y::AND
quién::who
pagará::will pay
acuerdo::agreement
Le::Him
costará::will cost
mundo::world
miles::thousands
millones::millions
dólares::dollars
Con::Angle
todo::everything
respeto::disrespect
Sr.::Mr.
vicepresidente::vice-president
costo::cost
hacer::make
sería::would
mas::more
alto::high
Al::Al
ritmo::pace
estamos::are
contaminando::polluting
medio::environment
ambiente::environment
Los::The
cascos::helmets
polares::polar
desaparecerán::will disappear
Profesor::Teacher
Nuestra::Our
economía::economy
tan::as
frágil::fragile
como::as
Debería::I should
tener::have
mente::mind
antes::formerly
declaraciones::declarations
sensacionalistas::sensationalist
Bueno::Good
último::last
trozo::chunk
separó::separated
tenía::i had
tamaño::size
Algunas::Some
personas::people
podrían::could
llamar::call
sensacional::sensational
Paren::Stop
conferencia::conference
En::In
donde::where
increíblemente::incredibly
nevando::snowing
Este::East
sin::without
precedentes::precedents
ha::ha
causado::caused
caos::chaos
Taxi::Taxi
taxi::taxi
Me::Me
gustó::liked
presentación::presentation
Muy::Very
enérgico::energetic
Gracias::Thank you
para::for
vinimos::we came
Para::For
entretener::entertain
gente::people
Definitivamente::Definitely
Quisiera::I would like
hablar::call
con::angle
usted::you
teoría::conjecture
Mi::My
nombre::name
Del::From
centro::center
Leí::I read
tratado::convention
las::the
corrientes::currents
marinas::marinas
Tomamos::We take
taza::cup
té::tea
Por::By
supuesto::alleged
logramos::we achieved
conseguir::get
Regresamos::We're back
acciones::actions
segundo::latter
tiempo::awhile
eh::huh
Sólo::Only
cerré::i closed
ojos::eyes
Gol::Goal
boya::buoy
NOMAD::NOMAD
muestra::shows
baja::casualty
temperatura::temperature
grados::degrees
Dónde::Where
bajío::bank
Hay::Is
muchas::many
olas::waves
ahí::there
deben::they must
haber::have
ajetreado::hectic
Pégale::Hit him
maldito::fucking
vamos::mush
Vamos::Mush
patéalo::kick it
Patéalo::Kick it
Van::Van
ganando::winning
Hola::Hello
Ya::Already
sabes::do you know
son::are
esas::those
juntas::gaskets
científicos::scientists
Chicas::Girls
vino::wine
fiesta::party
Vas::You're going
camino::lane
casa::house
Voy::I'm going
saliendo::coming out
oficina::office
furia::fury
huracán::hurricane
asombró::amazed
expertos::experts
Golpeando::Knocking
archipiélago::archipelago
estaba::i was
preparado::prepared
fuerza::force
cataclísmica::cataclysmic
meteorólogos::meteorologists
dicen::they say
más::more
fuerte::fort
medido::measured
vas::do you go
contestar::answer
Acabo::I just
ver::watch
reprobó::he reproved
cálculo::calculation
yo::me
también::also
recibo::receipt
copia::copy
calificaciones::qualifications
buen::good
estudiante::dropout
falla::flaw
sus::its
clases::classes
discutir::discuss
Tal::Such
debas::should you
Disculpa::Apology
soy::i am
quien::anyone
va::is going
por::by
meses::months
Es::Is
entiendo::i understand
Que::May
explique::explain
él::him
puedes::can you
llevar::carry
aeropuerto::airport
mañana::morning
tomar::drink
vuelo::flight
Entró::Entered
equipo::equipment
decatlón::decathlon
escuela::school
competirán::will compete
entró::came in
Sabes::You know
Creo::I think
chica::girl
Puedes::You can
recoger::collect
8:30::8:30 AM
Tengo::I have
colgar::hang
guardia::guard
noche::night
favor::favor
llegues::do you arrive
quiero::i want
Está::Is
bien::good
Ahí::There
estaré::i'll be
reunión::meeting
personal::personal
meteorológico::meteorological
sido::been
cambiada::changed
sala::courtroom
B.::B.
tienes::do you have
talento::gift
molestar::disturb
equivocada::wrong
porqué::why
tenías::did you have
Porque::Because
mi::my
hijo::child
sabe::knows
ciencia::science
tu::you
controla::controls
nuestro::our
presupuesto::budget
importa::does it matter
odia::hates
entiendes::do you understand
decir::say
nos::ourselves
recorta::cropped
Oh::Oh
diablos::damn
Espera::Wait
dónde::where
Dios::God
mío::mine
Lamento::Lament
llegar::arrive
papá::dad
pago::payment
estoy::i am
enojado::angry
desilusionado::disillusioned
Quieres::do you want
escuchar::listen
versión::version
pueden::can
versiones::versions
Resolví::I solved
todas::all
respuestas::answers
examen::examination
razón::reason
porque::because
escribí::i wrote
soluciones::solutions
Porqué::Why
Las::The
dijiste::you said
creyó::he believed
Dijo::He said
debí::i should have
trampa::cheating
Eso::It
ridículo::laughable
Cómo::How
reprueba::reproves
ser::be
listo::clever
le::him
dije::i said
tomó::took
recuerdas::do you remember
discúlpame::excuse me
Hice::I did
conclusiones::opinion
prematuras::premature
ese::that one
tipo::kind
arreglaremos::we will fix
Sam::Sam's
habla::talk
Vemos::We see
mal::evil
podrán::will be able
volver::become
esta::this
semana::week
Tu::Your
esposa::wife
regañará::will scold
apostar::bet
Oye::Hey
ven::come
sistema::system
tormenta::storm
enorme::huge
Estás::Are
Tiene::It has
miedo::fear
volar::fly
probabilidades::odds
avión::airplane
estrelle::estrelle
turbulencia::turbulence
menores::minors
millón::million
recuerdo::keepsake
hagas::do you do
caso::case
Siguen::They follow
sirviendo::serving
bebidas::beverages
Parece::It seems
habrá::will there be
poco::little
Les::Les
pedimos::we ask
abrochen::fasten
cinturones::belts
pongan::put
mesas::tables
asientos::seats
posición::location
vertical::down
Hasta::Even
esto::this
pase::passing
Agárralo::Grab it
Cuidado::Care
devuelves::do you return
puedo::can i
creer::believe
semanas::weeks
sola::alone
mamá::mum
Se::Be
paciente::patient
muy::very
emocionada::excited
vacaciones::holiday
amo::master
También::Also
llegamos::we arrived
Adiós::Goodbye
causa::cause
extremo::extreme
misterio::mystery
Algunos::Some
acreditan::accredit
manchas::stains
solares::solar
raro::odd
registrara::register
Ah::Aah
cierto::certain
Esa::That one
funcionó::did it work
otro::another
día::day
Veré::I'll see
barco::boat
Esta::This one
Pueden::They can
fallar::miss
improbable::improbable
Tenemos::We have
típico::typical
neoyorkino::new yorkino
Un::An
embotellamiento::gridlock
calles::streets
Mira::Mira
coches::cars
escapes::escapes
Contaminando::Contaminating
atmósfera::atmosphere
señor::lord
Llegaremos::We'll arrive
casi::almost
sólo::only
Caminemos::Let's walk
tienen::have
idea::idea
Hoy::Currently
están::are
agitados::agitated
conquistador::conqueror
español::Spanish
Derrotó::Defeated
emperador::emperor
montañas::mountains
peruanas::peruvians
pueblo::people
Cuál::Which
era::era
algo::any
Atahualpa::Atahualpa
Ése::That one
Tiempo::Awhile
puntos::dots
Siguiente::Following
pregunta::ask
qué::how
año::year
ascendió::it ascended
trono::throne
lugar::location
retro::retro
estaría::i would be
moda::fashion
fuera::outside
propósito::intent
todos::all
nerds::nerds
ves::do you see
preciosa::precious
increíble::incredible
cafetería::cafeteria
Estuviste::You were
grandiosa::grandiose
primera::first
ronda::patrol
Tú::You
Mis::My
compañeros::companions
Soy::I am
J.D.::J.D.
gustaría::would like
mostrara::will show
Claro::Clear
grandioso::grandiose
detenerme::stop me
claro::clear
Tienes::You have
seria::seria
competencia::competition
Apuesto::Handsome
niño::child
rico::delicious
Quién::Who
temprano::early
Encontramos::We found
extraordinario::extraordinary
perturbador::disturbing
Recuerda::Remember
habló::spoke
deshielo::thaw
polar::polar
podía::could
alterar::alter
ocurriendo::occurring
refiere::refers
nuestras::our
boyas::buoys
registró::registered
mandé::i commanded
email::email
Espere::Please wait
primero::first
pensamos::we think
funcionamiento::functioning
muestran::show
mismo::myself
resultado::outcome
Esto::This
Usted::You
predijo::predicted
sucedería::would happen
vidas::lives
hay::is
modelos::models
ni::nor
remotamente::remotely
capaces::capable
describir::describe
situación::condition
Excepto::Except
suyo::his
modelo::model
reconstrucción::reconstruction
Histórica::Historic
pronóstico::forecast
cercano::nearby
tenemos::we have
Nada::Nothing
había::there was
sucedido::happened
menos::least
últimos::last
Como::As
pronosticamos::we forecast
ayer::yesterday
oleaje::surf
Estas::These
aún::still
grandes::large
imaginé::i imagined
Miren::Look at
ustedes::you guys
deberías::should you
estar::be
cuidando::caring for
ruido::noise
Regreso::Return
enseguida::right away
costera::coastal
cerrado::closed
playas::beaches
Centro::Center
ocupado::busy
quieres::do you want
cayendo::falling
granizo::hail
pelotas::balls
golf::golf
presión::pressure
creando::creating
ciclónico::cyclonic
Pon::Put
canal::channel
debemos::we must
emitir::emit
advertencia::caveat
ciclón::cyclone
De::Of
estás::are
hablando::talking
vientos::winds
