depilación::Haarentfernung
Miré::ich schaute
casas::Häuser
creo::Ich denke
encontré::Ich habe gefunden
mejor::besser
perfecta::Perfekt
enviaré::Ich schicke
enlace::Link
reservar::reservieren
casa::Haus
ve::Gehen Sie weiter
increíble::unglaublich
idea::Idee
viaje::Reise
emocionante::spannend
cumplir::einwilligen
no::nicht
gran::groß
cosa::Ding
semana::Woche
tuve::ich hatte
paciente::Patient
estresada::gestresst
observación::Beobachtung
hice::ich tat
cursi::kitschig
suene::Ring
fue::Es war
es::ist
sólo::nur
número::Anzahl
tiene::Sie haben
edad::Alter
siente::fühlen
tanto::so viel
drama::Drama
Mierda::Mist
quema::brennen
Siempre::Immer
gustó::Er mochte es.
cáterin::Catherin
cumpleaños::Geburtstag
ofreció::angeboten
playa::Strand
Bien::Gut
son::sind
opciones::Option
lugar::Lage
Sólo::Nur
quiero::Ich möchte
agradecer::verstehen
planees::du planst
esto::dieses
sabes::Du weißt, dass du
hará::werden
mierda::Mist
llevaría::würde nehmen
restaurante::Restaurant
barato::billig
tendría::hätte
manejar::verwalten
vuelta::Schoß
estaría::Ich würde sein.
borracho::betrunken
suena::Es klingelt.
genial::cool
bueno::gut
venir::kommen
cierto::sicher
No::Nicht
Mamá::Mama
divertir::amüsieren
relajar::entspannen
Además::Außer
mamá::Mama
dejar::verlassen
hablar::Anruf
tercera::dritte
persona::Person
quizás::vielleicht
moderar::moderat
diversión::Spaß
común::häufig
Ya::Bereits
saben::Du weißt, dass du
sentar::setzen Sie sich
charlar::Chat
tomar::trinken
vino::Wein
reír::lachen
usar::verwenden
vestidos::Kleider
cómodos::Komfortabel
medio::Umgebung
Entienden::Du verstehst
Quiero::Ich möchte
tranquilo::friedlich
Nada::Nichts
loco::verrückt
Muere::Er stirbt
bajas::Verletzten
volumen::Lautheit
siento::Ich fühle mich
sí::Ja, ja.
Cumples::Du bist gut.
siglo::Jahrhundert
festejar::feiern
grande::groß
Bueno::Gut
recortaré::Ich schneide
flequillo::Randgruppe
salga::Raus
bien::gut
veras::Sie werden sehen
agradezco::Ich weiß es zu schätzen
inviten::Einladen
fallé::Ich habe gescheitert
última::Zuletzt
vez::Zeit
avión::Flugzeug
alquilar::lassen
extraños::Fremde
da::gibt
ansiedad::Angst
Usar::Verwenden
baño::Bad
gente::Menschen
Colchas::Steppdecken
raras::Seltsam
Todavía::Noch
quieren::Sie wollen
vaya::Oh, wow.
verdad::Ja, das tue ich.
alfombras::Teppiche
gigantes::Riesen
distancia::Entfernung
Saben::Du weißt, dass du
Ojalá::Hoffentlich
nunca::nie
aprendido::gelehrt
semen::Sperma
luz::Licht
negra::schwarz
demasiado::übermäßig
flor::Blume
pelo::Haar
ir::gehen
cenar::Abendessen
sola::Ganz allein
Necesito::Ich muss
salir::verlassen
estrenar::brandneu
rodillas::Knie
hora::Stunde
Ve::Vé
mujer::Mädchen
besemos::Lass uns küssen
rato::eine Weile
después::nach
hagamos::Lass es uns tun.
cucharita::Löffel
transformar::transformieren
enérgico::energisch
69::69
Probaron::Sie versuchten es
posición::Lage
llamada::Anruf
Es::Ist
muy::Sehr
sensual::heiß
tienes::Du hast es.
niños::kindisch
cama::Bett
único::nur
toca::Spielen
piecito::kleiner Fuß
sudado::Verschwitzt
Hablando::Ich rede
anoche::Letzte Nacht
usé::Ich benutzte
respirador::Verschnaufpause
antiapnea::Antiapnoe
decimos::Wir sagen:
ahora::jetzt
estoy::Ich bin
tienda::Geschäft
probando::Testen
ropa::Kleider
fiesta::Partei
muero::Ich sterbe
ver::sehen
pellizcar::Prise
culo::Hintern
consentimiento::Zustimmung
vemos::Wir sehen
Resolveremos::Wir werden es herausfinden.
dinero::Geld
estemos::wir sind
ahí::Dort
Mantengan::Halten Sie auf
piernas::Beine
cerradas::geschlossen
besos::Küsse
Estoy::Ich bin
teléfono::telefonieren
Recuerden::Oh, denk dran
pedí::Ich habe gefragt
chofer::Chauffeur
cuelgue::Auflegen
chicas::Mädels
Aún::Noch
sé::Ich weiß es.
Muy::Sehr
Llegamos::Wir sind hier.
Espero::Ich warte
tenía::ich hatte
buenas::Gut
reseñas::Bewertungen
internet::Internet
diré::Ich sagen,
miré::ich schaute
horribles::Schrecklich
supone::angenommen
buena::Gut
piscina::Becken
deslumbrante::blendend
suelta::Lassen Sie los
preocupación::Besorgnis
trago::trinken
entramos::Wir sind in
comestibles::Lebensmittel
veo::Ich sehe
ser::sein
protector::bewachen
cuida::Achten Sie darauf
deja::Lassen Sie los
lidie::Lidie
diablos::verdammt
hace::vor
evitar::vermeiden
hacer::machen
sociales::Soziale Fragen
quieres::Sie möchten
cuidar::Pflege
héroe::Held
veces::mal
retroceder::zurück
tome::Hier
papel::Papier
Seguro::Versicherung
invitará::wird einladen
mala::Schlecht
Claro::Klar
Cuida::Achten Sie darauf
espero::Ich hoffe
hermana::Schwester
mover::bewegen
tumba::Grab
probaré::Ich werde es versuchen.
receta::Rezept
Sí::Oh, ja.
gracias::vielen Dank
volver::werden
reunir::versammeln
hicieron::Sie taten
esfuerzo::Aufwand
Así::Das war's.
vida::Leben
valoro::I Wert
también::auch
valora::-Werte
hablo::Ich rede
pésimo::lausig
brindis::Toast
perdón::Vergebung
guste::Gefällt es mir
beber::trinken
Feliz::Glücklich
nosotras::uns
permiten::erlauben
divertido::Spaß
reunimos::wir sammeln
boda::Ehe
Tal::Das war's.
perdieron::Sie verloren
divorcio::Scheidung
banda::Band
era::Ära
tiempo::eine Weile
dicho::Sprichwort
amiga::Freund
Chicas::Oh, Mädels
pasa::Kommen Sie rein
rápido::schnell
serio::ernsthaft
necesitaba::Ich brauchte
extrañaba::Ich habe versäumt
coma::Koma
vuelve::Kommen Sie zurück
enviar::Mail
Chef::Küchenchef
punto::Punkt
abrir::öffnen
nuevo::neu
pregunta::Frage
productores::Produzenten
diferente::anders
programa::Tagesordnung
puntos::Weiche
suspensivos::aufschiebende
Disculpen::Oh, entschuldigen Sie mich.
trabajo::Job
desenchufar::Herausziehen
Estaré::Ich werde da sein.
presente::Geschenk
Enviar::Mail
fin::Ende
armé::ich stellte zusammen
itinerario::Reiseroute
falta::Mangel
lean::Lesen
ya::bereits
vean::Aussehen
estricto::Streng
actividades::Aktivitäten
den::Höhle
mirada::aussehen
haremos::Wir werden
minuto::Minute
preocupaciones::Bedenken
vistazo::aussehen
Genial::Cool
presión::Druck
tuviste::Du hattest
trabajando::Ansatz
menos::geringst
jóvenes::junge Menschen
Tomemos::Lass es uns nehmen.
foto::Foto
grupal::Gruppe
Necesitamos::Wir müssen
nueva::neu
noche::Nacht
selfis::Selfis
Más::Mehr
arriba::oben
más::mehr
cabeza::Kopf
abajo::unten
Naturales::Natürlich
Salió::Er ist draußen.
Esperen::Warte, warte, warte.
fantasma::Gespenst
lleva::nimmt
bebé::Baby
hacen::tun
bromeo::Ich mache Witze.
dueña::Eigentümer
traje::Kostüm
madera::Hartholz
fogata::Lagerfeuer
soy::Ich bin
envió::gesendet
corre::Laufen
rozagante::Rozagante
novia::Freundin
Segunda::Sekunde
Quizás::Vielleicht
celebramos::wir feiern
Pasarás::Du wirst vorbeigehen
finde::Ende
Vinimos::Wir sind hier.
pasear::für einen Spaziergang
tengo::Ich hab's.
frente::Vorderseite
equipo::Ausrüstung
tenis::Tennis
preparatoria::vorbereitend
grupo::Gruppe
baile::Tanz
quedaban::wurden übriggelassen
pantalones::Hose
unió::beigetreten
conocimos::wir trafen
pizzería::Pizzeria
Fue::Es war
destino::Reiseziel
estuve::Ich war
hicimos::Wir haben
amigas::Freunde
hecho::Tatsache
abrió::Er öffnete sich
propia::besitzen
cadena::Kette
aquí::hier
Pizzas::Pizza
Ricas::Reich
Nunca::Nie
amo::Meister
pizzas::Pizza
individuales::Individuum
congeladas::gefroren
cocino::ich koche
pizza::Pizza
entera::Ganze
adivina::Wahrsagerin
comiendo::Essen
evitas::Sie vermeiden
tristeza::Traurigkeit
Quieren::Sie wollen
Basta::Genug
estupideces::Dummes Zeug
allí::Dort
jacuzzi::Whirlpool-Badewanne
remojar::einweichen
fumar::Rauchen
Somos::Sind
discretos::diskret
así::wie diese
hagan::Tun Sie es
necesiten::du brauchst
días::Tage
eres::sind
años::Alter
murió::Er ist gestorben.
esposo::Ehemann
vendí::ich verkaufte
empresa::Unternehmen
jabones::Seifen
orgánicos::organisch
compró::gekauft
mal::Böse
Lamento::Klagegesang
pena::Kummer
tuvo::hatte
paro::Verhaftung
cardíaco::kardialen
joven::junger Mann
parece::Es scheint
evitable::vermeidbar
igual::gleich
Consumíamos::Wir haben
coca::Cocastrauch
útil::hilfreich
pequeña::klein
zona::Gebiet
zen::Zen
escapes::Flucht
espirituales::geistig
Silenciosa::Schweigen
conflictos::Konflikte
compañeras::Kameraden
cuarto::vierte
contemplar::nachsinnen
colibrís::Kolibri
meditar::meditieren
disfrutar::genießen
hermosa::schön
estatua::Statue
acerquen::Kommen Sie näher
fuente::Schriftart
gasté::ich verbrachte
hija::Tochter
puta::Nutte
antes::ehemals
digan::Sagen
apagar::auslöschen
hago::ich tue
funcionan::Sie arbeiten
retretes::Toiletten
irónico::ironisch
retrete::Latrine
aves::Vögel
Aquí::Hier
fogatas::Lagerfeuer
Encienden::Sie leuchten auf
jodido::gefickt
fuego::Licht
miran::aussehen
llamas::Flammen
piensan::sie/Sie denken
demonios::Oh, verdammt!
decidieron::entschieden
malvaviscos::Marshmallows
está::ist
costando::Kostenrechnung
conectar::verbinden
correo::Post
difíciles::schwierig
tienen::haben
lento::Verlangsamen
tendrán::werden haben
beben::Sie trinken
litros::Liter
recuerden::Denken Sie daran
diga::Hallo
probablemente::Wahrscheinlich
sea::Sei es
sintieron::Filz
siempre::immer
alcohol::Alkohol
Vemos::Lass uns sehen.
vista::Sehkraft
Está::Ist
justo::fair
portón::Tor
Santísima::Heilig
madre::Mutter
paraíso::Paradies
romper::brechen
horrible::schrecklich
falso::Fälschung
real::tatsächlich
dormir::schlafen
afuera::außerhalb
estrellas::Sterne
pijamada::Übernachtungszeit
aire::Atmosphäre
libre::frei
tampoco::entweder
dónde::wo
enchufar::Stecker in
ríen::Sie lachen
broma::Witz
tenemos::Wir haben
cosas::Dinge
atender::Cater
abejas::Bienen
Supongo::Ich schätze, so
granja::Farm
Haces::Du machst
miel::Honig
pican::Sie stechen
mucho::viel
desarrolla::entwickelt
inmunidad::Immunität
placer::Freude
casi::fast
obvio::offensichtlich
pila::Heap
tonterías::Unsinn
tóxicas::giftig
largaré::Ich werde rauskommen
Luego::Später
consultar::beraten
durmamos::Lasst uns schlafen
gusta::Gefällt es mir
Hablar::Anruf
encanta::Lieben Sie es
Haremos::Wir machen es.
programado::geplant
recostar::legen Sie sich hin
primero::zuerst
lista::Liste
desempacar::entpacken
descansar::Rest
minutos::Protokoll
Pondré::Ich setze es.
cronómetro::Chronometer
reserva::Buchung
dijo::sagte er:
mascotas::Haustiere
decir::sagen
molesta::ärgerlich
especialmente::besonders
mujeres::Frauen
asuman::annehmen
automáticamente::automatisch
pelear::Kampf
salía::ich habe ausgezogen
llorando::weinen
quedé::ich blieb
claro::klar
bromas::Witze
afortunadas::Glückliche
tontitas::Dumme
tontita::Du kleiner Narr
Oye::Ey
tan::als
lejos::fern
creí::Ich dachte
quedaba::wurde übrig
cerca::Nähe
Tengo::Ich hab's.
botas::Stiefel
cómodas::Komfortabel
tacos::Tacos
espalda::zurück
Sabes::Oh, du weißt schon.
curar::heilen
mente::Verstand
mentira::Lüge
Cómo::Wie
vas::Du gehst hin.
nuevas::neue
alcanzamos::Wir erreichen
Salud::Gesundheit
llamo::Ich rufe an.
atenderé::Ich kümmere mich darum.
hambre::Hunger
pediremos::wir werden fragen
Sabemos::Wir wissen, dass
queremos::Wir wollen
pedimos::wir fragen
agua::Wasser
luego::Später
contaré::Ich sagen,
alergias::Allergien
Gracias::Vielen Dank.
agradecemos::Wir bedanken uns bei Ihnen
hay::ist
problema::Problem
Dije::Ich sagte:
nombre::Name
recién::nur
noto::Ich fühle mich
dije::Ich sagte:
Sé::Ich weiß es.
pongo::ich setze
rara::Seltsam
mandona::herrisch
viajes::reisen
Trataré::Ich werde es versuchen.
controlar::Kontrolle
temo::Ich fürchte, ich habe Angst.
arruinar::Schlag
estamos::sind
dices::Du sagst:
aplico::ich bewerbe
pacientes::Patienten
amortiguador::Stoßdämpfer
emocional::emotional
dar::geben
opinión::Meinung
consejo::Rat
directamente::direkt
Alguna::Jeder
probaste::Du hast es versucht
método::Methode
humeante::Dämpfen
lado::Kante
Compartamos::Lasst uns teilen
palomitas::Popcorn
maíz::Mais
lavanda::Lavendel
costado::Flanke
botella::Flasche
sal::Raus
marina::Marine
condimentar::Würze
combinación::Kombination
interesante::interessant
alcanzar::erreichen
partes::Teile
exnovia::Ex-Freundin
acaba::Es ist vorbei
mudar::bewegen
enojada::zornig
disfruten::Genießen
Oyeron::Du hast gehört.
santa::Heilig
señal::Queue
jugar::zocken
bolos::Bowling
averigua::Finden Sie es heraus
decidir::entscheiden
gata::Buchse
tomó::nahm
pastilla::Raute
entiendo::Ich verstehe
plazo::Frist
corto::kurz
Puntos::Punkte
teléfonos::Telefone
deberíamos::Wir sollten
mirando::auf der Suche
Tiene::Er hat es.
razón::Grund
detendré::Ich werde aufhören.
parar::pausieren
pensando::Denken
Peneando::Bußgelder
Sugirió::Er schlug vor
peneando::Bußgelder
ridículo::lachhaft
domingo::Sonntag
enfoquemos::Konzentrieren wir uns
feliz::glücklich
tu::Sie
día::Tag
especial::besondere
Toma::Aufnahme
favorita::Favorit
hongos::Pilze
pimientos::Paprika
cantar::verrichten
trabajábamos::Wir haben gearbeitet
resumen::Überblick
daremos::Wir werden geben
propina::Spitze
vegana::Vegan
ahumado::Geräuchert
jalapeños::Jalapeños
Paja::Spreu
viejo::alt
San::Heiliger
primera::zuerst
recibir::bekommen
regalo::Geschenk
pujó::Er bot
grandes::Große
bebés::Babys
hermosos::schön
tocar::fühlen
campana::Kapuze
Disfruta::Genießen Sie es
bolsa::Tasche
húmeda::Nass
cachorro::Tigerjunges
callado::Ruhig
cafetería::Cafeteria
Oí::Ich habe gehört.
perder::verlieren
viene::Er kommt.
reloj::Uhr
llama::Flamme
ejecutivo::Exekutive
Dedica::Engagiert
conviertas::konvertieren
sala::Gerichtssaal
juntas::zusammen
presiden::Vorsitz über
último::zuletzt
pene::Penis
fuerte::Festung
soldadito::Kleiner Soldat
caro::teuer
baratija::Schmuck
cualquiera::jeder
sombrero::Hut
También::Auch
vibra::vibriert
Escuchen::Hören Sie auf
época::Ära
triste::trostlos
Éramos::Wir waren
hermanas::Schwestern
batalla::Schlacht
valientes::mutig
eructo::rülpsen
gas::Gas
collar::Halskette
retro::Retro
Tienes::Du hast es.
vives::Du lebst
oficialmente::offiziell
conozco::Ich weiß es.
ven::Komm schon.
Hay::Ist
dudo::Ich bezweifle es
miedo::Angst
servilletas::Servietten
estén::sind
embrujadas::verfolgt
asombroso::erstaunlich
graciosa::Lustig
conquisto::Ich erobere
Hago::ich tue
trucos::Tricks
Espera::Warte, warte, warte.
Soy::Ich bin
artista::Künstler
ves::Siehst du
adelante::vorwärts
quitaré::Ich nehme weg.
lentes::Brille
Mira::Mira
filtro::Filter
lindo::süß
adivinar::erraten
sigue::Gehen Sie weiter
Mejor::Besser
Childish::Herr Kindisch
símbolo::Symbol
$::$$
dice::Er sagt:
listas::-Listen
dio::gab
charla::Chat
TED::TED
vulnerabilidad::Verwundbarkeit
investigadora::Ermittler
cuentacuentos::Geschichtenerzähler
vergüenza::Verlegenheit
valor::Mut
contagioso::ansteckend
famosa::berühmt
interesa::Es ist interessant
sentido::Bedeutung
vienen::Sie kommen
famosos::berühmt
pasada::Vergangenheit
perdí::ich verlor
vendrá::wird kommen
Pasado::Vergangenheit
Santo::Heilig
vayamos::Lass uns gehen.
conocer::treffen
molestemos::Lass uns die Mühe machen
Dejemos::Lasst uns aufhören.
señora::Dame
lamentamos::Es tut uns leid.
interrumpir::unterbrechen
piel::Pelz
Tenemos::Wir haben es.
preguntas::Fragen
diferencia::Unterschied
enfrentar::konfrontieren
unir::kombinieren
naturaleza::Natur
transformación::Transformation
confort::Komfort
cómo::wie
generosa::großzügig
apreciaciones::Einschätzungen
demás::andere
odio::Hass
generosos::großzügig
poner::legen
límites::Grenzen
Límites::Grenzen
Mensaje::Nachricht
recibido::Erhalten
quería::Ich wollte
Hasta::Sogar
Da::Da
mano::Hand
cariño::Honig
Sientes::Fühle es
late::Es schlägt
corazón::Herz
entiendes::Du verstehst
mismo::mich
soñando::träumen
prendió::Es hat sich eingeschaltet
eterna::ewig
crear::schaffen
libra::Pfund
queso::Käse
maldigo::Fluch
pongan::Setzen Sie es auf
cómoda::Kommode
seguir::weiterhin
señoritas::Meine Damen
Hermosa::Schön
manada::Herde
sensuales::Sinnlich
bienvenidas::willkommen
siguiente::nach
capítulo::Kapitel
velada::Abend
temprano::früh
tarde::Nachmittag
Siento::Es tut mir leid.
pasaron::Sie bestanden
momento::Moment
Antes::Ehemals
miren::Aussehen
raro::ungerade
juzguen::Richter
escuché::Ich habe gehört.
microdosis::Mikrodosis
tomamos::Wir nehmen
metanfetaminas::Methamphetamine
aparentemente::anscheinend
tener::haben
experiencia::Erfahrung
intensa::intensiv
escucho::Ich höre zu
consumiremos::wir werden verbrauchen
rola::Rola
pase::flüchtig
aspirar::streben
éxtasis::Ekstase
Creí::Ich dachte, so
canción::Lied
Aspiran::Sie saugen
cantan::Sie singen
pregunto::Ich frage
interactúa::interagiert
medicación::Medikation
tomo::Ich nehme es.
tomando::nehmen
levotiroxina::Levothyroxin
bupropión::Bupropion
fluoxetina::Fluoxetin
calcio::Kalzium
actaea::Er ist schauspielerisch
racemosa::Rennemose
sudores::Schwitzen
nocturnos::jeden Abend
ranitidina::Ranitidin
rariprofeno::rariprofen
tal::solch
tipo::Art
Mañana::Morgen
maratón::Marathon
carrera::Karriere
velocidad::Zahnrad
escuchen::Hören Sie auf
Suena::Es klingelt.
escucharía::Ich würde zuhören.
encantaría::Ich würde gerne
escuchar::hören
aflijas::Bedrängnisse
interesan::sind interessant
drogas::Drogen
miles::Tausende
nombramos::wir nennen
volvió::Er ist zurück.
novio::Freund
Bailemos::Lass uns tanzen
bailar::Tanz
deber::Pflicht
Primero::Zuerst
película::Film
Flashdance::Flashdance
una::ein
Hagamos::Lass es uns tun.
clásico::Klassiker
rock::Fels
Pongamos::Lass es uns holen.
arruinó::ruiniert
totalmente::völlig
pasó::Es geschah
Evadía::Er hat sich entgeweidet
impuestos::Steuern
Enloqueció::Er ist verrückt geworden.
Creo::Ich denke, so
posterior::später
actual::Strom
Desearía::Ich wünschte
volviera::komm zurück
cantara::wird singen
serenata::Serenade
horas::Stunden
enteras::Ganze
hiciera::zu tun
amor::Liebe
digas::Du sagst:
deslizó::ist ausgerutscht
ascensor::Aufzug
maldita::Blutige Hölle
puerta::Tür
cerró::geschlossen
puf::Sitzsack
Dónde::Wo
hermoso::schön
Amo::Meister
Tenía::ich hatte
ojos::Augen
cervatillo::Rehkitz
nacido::geboren
dolía::Es hat weh getan
cadera::Hüfte
sabe::Du weißt, dass du
fácil::einfach
universo::Universum
diciendo::Sprichwort
Escucho::Ich höre zu
héroes::Helden
están::sind
muriendo::Sterben
envejeciendo::alt werden
peor::Schlimmer
morir::sterben
juro::Ich schwöre es.
pasara::Es wird vorübergehen
algo::jeder
preocuparía::Ich würde mir Sorgen machen
pobres::Armen
hijos::Kinder
querer::Liebe
Son::Sind
angelitos::Kleine Engel
Recuerdas::Erinnern Sie sich
lanzaba::ich habe geworfen
guitarra::Gitarre
técnico::technisch
atrapaba::ich habe erwischt
alucinante::Großartig
atraparé::Ich werde fangen.
roca::Fels
Ahora::Jetzt
veamos::Lass uns sehen.
palabra::Etage
emociones::Emotionen
Ver::Sehen
lagos::Seen
rema::Zeile
bote::Boot
mental::mental
arroyo::Bach
distinto::anders
agradable::nett
permiso::verlassen
paella::Paella
preparando::Vorbereitung
vengo::Ich komme.
olvidó::Er vergaß
mencionar::erwähnen
idiota::Idiot
eras::Du warst
Vengo::Ich komme.
guía::Anleitung
turístico::Tourist
chef::Küchenchef
vine::Ich kam
ayer::Gestern
Fui::ich ging
buscar::aussehen
amiguito::Freund
levantaré::Ich werde aufstehen.
proceso::Rechtsstreit
Demora::Verzögerung
bastante::gerecht
empezar::beginnen
precioso::süß
Escucharon::Du hast gehört.
sepia::Tintenfisch
dicen::sie/Sie sagen
Apesta::Es stinkt
primo::Cousin
jibión::Jibion
calamar::Tintenfisch
predador::Raubtier
verán::Sie werden sehen
sabor::Geschmack
dulce::frisch
Quiere::Er will
proteína::Protein
tradicional::traditionell
marisco::Meeresfrüchte
arroz::Reis
pondrías::du würdest setzen
hielo::Eis
Señoritas::Meine Damen
necesitan::sie/Sie brauchen
avisen::Warnen
país::Land
haces::Du machst
favor::Gefallen
ayudarías::du würdest helfen
llamadores::Anrufer
ángeles::Engel
ranas::Frösche
cerámica::Keramik
enredaron::verstrickt
atrapasueños::Traumfänger
ruido::Lärm
dejó::Er ist gegangen.
Maldita::Blutige Hölle
Dormir::Schlafen
superimportante::super wichtig
Muestra::Zeigen Sie es
Había::Es gab
pájaro::Vogel
ruidoso::laut
callar::Stille
llave::Schlüssel
entraste::Du kamst rein
sienten::fühlen
Preparamos::Wir bereiten uns vor
café::Kaffee
mariscos::Meeresfrüchte
apretar::Quetschen
botón::Schaltfläche
Aprieto::Reparieren
duchaste::Du hast geduscht.
estás::sind
duchar::Dusche
té::Tee
fuentes::Quellen
caliente::heiß
tetera::Teekanne
paré::Ich habe aufgehört
quedaron::wurden übriggelassen
despiertas::aufwachen
interna::intern
acostamos::Wir gingen ins Bett
irrumpe::Es bricht ein
a.m.::MORGENS
tarotista::Tarotist
haga::tun Sie es
funcionar::Funktion
cafetera::Kaffeemaschine/Kaffeemaschine
imposible::unmöglich
encontrar::finden
señalizada::ausgeschildert
psíquica::psychisch
Valga::Es lohnt sich
sepa::wissen
pondré::Ich setze es.
necesitaré::Ich werde brauchen.
limpiar::sauber
toma::Aufnahme
recorre::Gehen Sie herum
esparce::streut
tímida::schüchtern
Tendremos::Wir werden es haben.
esté::ist da
contaminado::kontaminiert
Preferentemente::Vorzugsweise
Deja::Lass es los.
permites::Sie erlauben
coristas::Chor
veremos::Wir werden sehen.
carroza::schweben
tatuaje::Tattoo
carta::Brief
positiva::positiv
sale::Es kommt raus
salió::kam heraus
hacia::zum
arrastra::schleppt
control::Kontrolle
cambio::ändern
drástico::drastisch
caída::fallen
mantienes::Du behältst
ocupada::beschäftigt
contrario::im Gegenteil
sientes::Du fühlst dich
literalmente::buchstäblich
Aun::Sogar
buen::Gut
pentáculos::Pentakel
significa::Mittel
pérdida::Verlust
económica::ökonomisch
pobreza::Armut
suerte::Glück
gusto::Geschmack
oportunidad::Gelegenheit
quisiera::Ich wünschte
televisión::Luftwellen
señala::weist darauf hin
este::Osten
representa::repräsentiert
nuevos::neue
inicios::Anfänge
optimismo::Optimismus
cuesta::Es kostet
aprovechar::Hebelwirkung
oportunidades::Möglichkeiten
enfoca::Fokus
necesidades::brauchen
priorizar::priorisieren
bolilla::Ball
rieron::Sie lachten
diablo::Teufel
Representa::Es stellt
fuerzas::Kräfte
violentas::gewalttätig
agobiar::überwältigen
muerte::Tod
despedida::Abschied
negativa::negativ
asustan::Sie erschrecken
realidad::Aktualität
indica::zeigt an
vieja::alt
paso::flüchtig
metamorfosis::Metamorphose
Estás::Sind
convertir::konvertieren
mariposa::Schmetterling
significar::bedeuten
acerca::über
rueda::Rad
fortuna::Vermögen
ciclos::Zyklen
decisivo::entscheidend
Medio::Umgebung
Ves::Siehst du
inmóvil::bewegungslos
paz::Frieden
Agotada::Auspuff
acabada::abspritzen
lectura::Lesung
Sabe::Du weißt, dass du
despedir::entlassen
terminamos::Wir sind fertig.
Olviden::Vergiss es
Espere::Warte, warte, warte.
malo::schlecht
jardín::Garten
general::allgemein
serpientes::Schlangen
rocas::Felsen
Verán::Sie werden sehen
lucha::Kampf
muestran::zeigen
rodeadas::umgeben
batallas::Schlachten
entrelaza::Interlacing
bate::Fledermaus
duelo::Duell
cientos::Hunderte
gruesa::Brutto
formado::gebildet
preservar::bewahren
amistad::Freundschaft
secretos::Geheimnisse
espacio::Freigabe
unidas::vereint
creen::glauben
Ven::Komm schon, komm schon.
piedras::Steine
río::Fluss
gemas::Edelsteine
dinámicas::dynamisch
facetas::Facetten
gastaron::ausgegeben
lisas::glatt
opacas::undurchsichtig
Envejecidas::Älter
señoras::Meine Damen
superen::Überwinden
mierdas::Oh, Mist
dólares::Dollar
oficina::Büro
avisar::Warnen
resultados::Nachwirkung
marcha::Marsch
Entendido::Ich hab's.
órdenes::Bestellungen
escucha::Zuhörer
va::Gehen
oferta::Angebot
nove::Nove
Sorete::Sorete
cagado::Abgefickt
Perdona::Es tut mir leid.
entrometida::Einmischen
traer::bringen
cura::heilen
resaca::Kater
Disculpa::Entschuldigung
estresarme::Stress mich
Tener::Haben
administrar::verwalten
propiedades::-Eigenschaften
cagada::Scheißkerl
conoces::Du weißt, dass du
sorprendería::Ich würde überrascht sein.
Paso::Flüchtig
enteros::Ganzzahlen
cata::Verkostung
vinos::Weine
hoy::zurzeit
empieza::Starten
oración::Gebet
paren::Stoppen Sie es
enseguida::Sofort
tendré::werde ich
cuenta::Konto
jugo::Saft
basura::Müll
jabón::Seife
ayuda::Hilfe
resabio::Nachgeschmack
comestible::essbar
forma::Formular
belleza::Schönheit
espaciosa::geräumig
tracción::Traktion
todoterreno::GELÄNDEWAGEN
Quisiera::Ich möchte
acercar::Nähe
paisaje::Landschaft
terreno::Feld
vuelvan::Kommen Sie zurück
pensar::zu denken
amigo::Freund
miniván::Minivan
asientos::Sitze
pesadilla::Albtraum
posavasos::Untersetzer
ventilación::Lüftung
configurable::konfigurierbar
luces::Lichter
seguridad::Sicherheit
kit::Bausatz
emergencia::Notfall
andando::Lass uns gehen.
celebrar::feiern
cumples::Du machst
linda::schön
asunto::Angelegenheit
avergüenza::Schande über dich
cumplo::ich tue
Cumpleaños::Geburtstag
pasé::ich bestanden habe
poco::wenig
agudo::akut
bodega::Keller
primer::zuerst
viñedo::Weinberg
pertenecieron::gehörte
señor::Gebieter
plantar::Pflanze
uvas::Trauben
escribió::Er schrieb
camarera::Kellnerin
bonita::schön
romance::Romantik
metas::Ziele
durmiendo::Schlaf
aún::Noch
preciosa::Schön
sitio::Website
fotos::Bilder
compartidas::geteilt
aceptaste::Sie haben akzeptiert.
invitación::Einladung
recibí::Ich hab's.
invitarían::würde einladen
aceptaría::Ich würde akzeptieren
delicioso::köstlich
tinto::rot
niveles::Niveau
saludables::gesund
tanino::Tannin
aprender::lernen
creó::erstellt
propósito::Absicht
contaminemos::Lasst uns verschmutzen
sugerencias::Anregungen
negativas::negativ
Amén::Amen
contaminación::Kontamination
agregada::Attaché
ponemos::wir setzen ein
música::Musik
borrachas::trunken
arrestaron::Verhaftet
juego::Spiel
canciones::Lieder
culpa::Schuld
disfrutamos::Wir haben es genossen
legal::legal
Menos::Geringst
Miro::ich schaue
ventana::Fenster
sucia::garstig
autos::Autos
ciudad::Stadt
Pasan::Sie gehen vorbei
Sentada::Setz dich hin
salen::Sie kommen raus
calor::Hitze
relajante::Entspannend
allá::Da drüben
Busco::Ich suche
ritmo::Tempo
fea::Hässlich
centro::Zentrum
crecen::erwachsen werden
viven::leben
alrededor::um
cabernet::Cabernet
sauvignon::Sauvignon
rey::König
chardonnay::Chardonnay
reina::Königin
audaz::fett
vinería::Weingeschäft
pasará::Es wird vorübergehen
mañana::Morgen
vivamos::Lass uns leben
festejemos::Lasst uns feiern
reventar::platzen
llamar::Anruf
agente::Agent
toque::Hinweis
madreselva::Geißblatt
Huelan::Sie riechen
Digan::Sagen
huelen::Sie riechen
respuestas::Antworten
incorrectas::falsch
verde::grün
Diría::Ich würde sagen,
enlatados::Dose
Dijo::Er sagte:
incorrecto::falsch
duraznos::Pfirsiche
aroma::Aroma
duda::Zweifel
equivocar::irren
Atroz::Grauenhaft
atroz::grauenhaft
Perdimos::Wir haben verloren
show::zeigen
juezas::Richter
importancia::Wichtigkeit
cuanto::wie viel
Hablo::Ich rede
sigues::Du gehst weiter.
esperas::Warten Sie
Requieren::Sie benötigen
atención::Aufmerksamkeit
importante::wichtig
cara::Gesicht
daré::ich werde geben
preciado::kostbar
hagas::Tun Sie
haz::Bündel
bailando::tanzen
escribí::Ich schrieb
aros::Reifen
tonto::Narr
equivoqué::Ich habe mich geirrt
trata::Versuchen
números::Zahlen
importan::Angelegenheit
entendiera::Ich verstehe
Importa::Es ist wichtig
dentro::Innenseite
dirías::würdest du sagen
alma::Kern
suficiente::genug
follar::ficken
Casi::Fast
vivo::lebendig
auto::Auto
propio::besitzen
bicicleta::Fahrrad
llamaba::ich habe angerufen
completa::abgeschlossen
negación::Leugnung
cumple::Er erfüllt
quita::Abheben
sentir::fühlen
difícil::schwierig
reservas::Reservierungen
personas::Menschen
millones::Millionen
lugares::Orte
distintos::anders
hiciste::Du hast es getan.
excelente::ausgezeichnet
saber::wissen
Quizá::Vielleicht
rico::köstlich
Fondo::Fonds
blanco::Platzpatrone
prisa::beeilen
seleccionado::ausgewählt
degustar::Geschmack
comprar::kaufen
agitado::Aflattern
quedes::Bleiben
atrás::vor
nombres::Namen
club::Klub
pedalear::Pedal
compras::Shopping
Compraremos::Wir kaufen
evitamos::wir vermeiden
aeropuerto::Flughafen
Compraré::Ich kaufe
sombrerote::Hut
veneno::Gift
Pizza::Oh, Pizza
gastar::verbringen
usa::verwendet
energía::Energie
solar::solar
orgánica::organisch
sulfatos::Sulfate
pesticidas::Pestizide
sol::Sonne
provee::bietet
Notarán::Sie werden es bemerken
orgánico::organisch
sedimento::Sediment
fondo::Fonds
copa::trinken
preguntaba::ich habe gefragt
Puede::Vielleicht
Sedimento::Sediment
Lodo::Schlamm
Viruta::Chip
Sobras::Essenreste
Mineralidad::Mineralität
Responderé::Ich werde antworten.
Diamantes::Karo
supuesto::mutmaßlich
Cierto::Sicher
vinieron::Sie kamen
Pasar::Pass
paneles::Paneele
solares::solar
acelerar::beschleunigen
generan::generieren
kilovatios::Kilowatt
Estaba::Ich war
tierra::Land
exacto::exakt
Iremos::Wir gehen.
caminar::Spaziergang
regla::Menstruation
caminen::Spaziergang
viñedos::Weinberge
Diviertan::Viel Spaß
cansa::Es wird müde
rete::rete
trabajar::betreiben
dedicamos::wir widmen
jodida::Abgefickt
Juguemos::Lasst uns spielen
trabajaría::Ich würde arbeiten
librería::Buchhandlung
liberal::links
ecológica::umweltfreundlich
lluvioso::regnerisch
melancólico::melancholisch
conductora::Treiber
pulidora::Polierer
cada::jeder
frío::kalt
pasar::Pass
calores::Hitze
turno::Drehen
sería::würde sein
magia::Magie
Totalmente::Völlig
opción::Option
haría::Ich würde
contacto::Kontakt
visual::visuell
Mientras::Als
robo::Raub
billeteras::Portemonnaies
fuéramos::Wir sollten gehen.
quiere::Er will
fanática::Fanatiker
espantapájaros::Vogelscheuche
cagar::ficken
encima::oben
cagaste::Du hast es vermasselt.
fábrica::Fabrik
olía::gerochen
daban::gab
ganas::Appetit
caca::Mist
había::gab es
tapaban::Sie haben vertuschert
olor::Geruch
torna::dreht sich zurück
círculo::Kreis
vicioso::boshaft
definitiva::endgültig
cavado::gegraben
pienso::füttern
verá::Sie werden sehen
tenga::Hier
70::70
como::als
barba::Bart
candado::Vorhängeschloss
canosa::grau
quitaste::Du bist abgehauen.
Quedó::Es ist übrig.
fino::Geldbuße
tierno::sanftmütig
coronel::Oberst
Justo::Das ist richtig.
mentón::Kinn
estilo::Stil
planeas::Sie planen
visitar::Anruf
vagina::Vagina
músico::Musiker
jazz::Jazz
referías::Empfehlungen
patatas::Kartoffeln
fritas::Gebraten
llena::voll
lodo::Schlamm
Será::Es wird sein
bebas::Trinken Sie auf
alarmada::alarmiert
Necesita::Er braucht
locura::Wahnsinn
carteles::Plakate
Ahí::Gleich da
sigan::Weiter geht's
disculpe::Entschuldigen Sie mich.
Disculpe::Oh, entschuldigen Sie mich.
importara::es zählt
cartel::Rechnung
apunta::Ziel
pasivo::passiv
agresiva::aggressiv
agresivo::aggressiv
zapatos::Schuhe
limpios::sauber
Están::Sind
Avancen::Vorwärts bewegen
navegar::navigieren
Estuvieron::Sie waren
Estaban::Sie waren
adivinen::Ratet mal, was
llegué::Ich bin hier.
gracioso::lustig
Hoy::Zurzeit
comí::Ich habe gegessen
diamantes::Karo
borracha::trunken
enana::Zwerg
Guiño::Zwinkern
guiño::Zwinkern
raros::Seltsam
odian::Sie hassen
adoran::Sie lieben
encantan::Sie lieben sie
nena::Baby
malinterpretes::Sie missverstehen
mereces::Du hast es verdient.
mundo::Welt
ni::noch
perlas::Perlen
querida::Liebling
creció::aufgewachsen
dedicar::widmen
tetas::Titten
chicos::Hey, Jungs.
toquemos::Lasst uns spielen
Cierra::Schließen Sie es
profesional::Profi
calma::beruhigen
cambió::geändert
camisetas::T-Shirts
dron::Drohne
Dijiste::Du sagtest:
estaba::Ich war
entre::zwischen
entrará::wird hereinkommen
quedamos::Wir blieben
Tocan::Sie spielen
tune::Melodie
cuevas::Höhlen
serían::würde sein
probar::versuchen
consumió::konsumiert
chico::Junge
mordió::Er hat gebissen
garaje::Garage
mantiene::unterhält
despierto::wach
debo::Ich muss
probemos::Lassen Sie uns versuchen
nerds::Nerds
cabalgata::Festzug
contra::gegen
dura::schwer
cuerpo::Körper
comillas::Anführungszeichen
armonizar::harmonisieren
tremenda::Schrecklich
acústica::Akustik
divertida::Spaß
haré::werde ich
Pésima::Schrecklich
dedico::ich widme
perdimos::Wir haben verloren
dijeron::sie/Sie sagten
evitara::vermeiden
observaciones::Beobachtungen
instinto::Instinkt
señales::Signale
relajes::Relais
busco::Ich suche
agenda::Tagesordnung
armaste::Du hast zusammengesetzt
impide::verhindert
llevar::tragen
acomodaría::würde unterbringen
encargaría::Ich würde bestellen
Avisa::Sag es mir.
donde::wo
egoísta::Egoist
Respira::Atmen
hablemos::Lass uns reden.
acomodando::Aufnahme von bis
matrimonio::Ehe
acomodó::untergebracht
mensajes::-Nachrichten
chica::Mädchen
lastimará::Er wird wehtun.
crisis::Krise
mediana::Median
incapacidad::Unfähigkeit
lidiar::Deal
eso::es
mirar::aussehen
espejo::Spiegel
terapista::Therapeut
terapia::Therapie
acomodar::unterbringen
basta::genug
apartada::abgelegen
aleja::Wegziehen
peleemos::Lasst uns kämpfen
hablamos::Wir haben geredet
negativo::negativ
realmente::eigentlich
estupidez::Unsinn
llorar::weinen
respecto::Respekt
muere::Er stirbt
terremotos::Erdbeben
mata::Mastix
lloro::Ich weine
invalida::ungültet
sentimientos::Gefühl
privilegios::-Privilegien
blancos::weiß
hacemos::wir tun
medioambiente::Umgebung
peces::Fisch
plástico::Kunststoff
inundando::Überschwemmungen
océano::Ozean
quedan::sind übrig
rinocerontes::Nashörner
contó::gezählt
contar::zählen
desagrada::Es enttäuscht
adoramos::Wir verehren
personaje::Charakter
príncipe::Prinz
importa::Es ist wichtig
tirar::schleudern
sabremos::Wir werden es wissen.
izquierda::links
derecha::Recht
contestó::Er antwortete:
exhibición::Ausstellung
arte::Kunst
Sabía::Ich wusste es.
contestaría::Ich würde antworten
perfecto::perfekt
Elijamos::Lassen Sie uns wählen
silencio::Stille
cagamos::Wir haben es vermasselt
odiar::hassen
muro::Wand
cajas::Boxen
cambiará::wird sich ändern
humor::Stimmung
respuesta::Antwort
lamento::Klagegesang
única::einzigartig
supe::Ich wusste es.
vio::Säge
juventud::Jugend
apesta::Es stinkt
palabras::Worte
memoria::Speicher
creer::glauben
siguiendo::nach
pasos::Fußabdruck
ídolos::Idole
honor::Ehre
Claramente::Deutlich
caravanas::Wohnwagen
cojones::Eier
Empecemos::Lassen Sie uns loslegen
niñera::Kindermädchen
serie::Anzahl
psicodrama::Psychodrama
posmoderno::postmodern
clasismo::Klassismus
ambición::Ehrgeiz
ícono::Symbol
base::Grundlage
cultural::kulturell
gustaría::Ich möchte
comentarios::Kommentare
contextual::kontextuell
independiente::unabhängig
consciencia::Bewusstsein
lettera::Lettera
reacción::Spiel
experiencias::Erfahrungen
rodean::umgeben
vi::vi
impida::verhindern
participar::teilnehmen
deba::sollte
obra::Œuvre
alegra::Froh
sintieras::du fühlst
ofendida::beleidigt
Consideraste::Sie haben in Betracht gezogen
Alf::Alf
enfoco::Ich konzentriere mich
Digo::Ich meine...
Miran::Sie sehen aus
programas::-Programme
competencias::Kompetenzen
películas::Filme
confirmo::Ich bestätige
transmitir::ausgestrahlt
vs::vs
emitir::emittieren
mayor::Major
evito::ich vermeide
vuelva::Kommen Sie zurück
hiere::Es tut weh
preocupa::Es macht sich Sorgen
Pueden::Sie können
conseguir::bekommen
porno::Porno
facilidad::Einrichtung
Solía::Früher habe ich
kilómetros::Meilen
plena::voll
puesto::Außenposten
estación::Depot
autobuses::Busse
lésbico::lesbisch
afortunados::Glückliche
pensado::Gedanke
temen::sie/Sie fürchten
sexualidad::Sexualität
asocian::assoziiert
largas::Lange
distancias::Entfernungen
Tienen::Sie haben
autoestima::Selbstwertgefühl
criticamos::wir kritisieren
saludable::gesund
fiasco::Fiasko
leí::ich lese
poesía::Poesie
público::Publikum
completo::voll
aplausos::Applaus
chasquidos::Einrasten
total::insgesamt
miró::sah aus
confirmó::bestätigt
pedazo::Prachtkerl
hizo::tat
escritora::Autor
necesita::du brauchst
herir::verletzen
Nacieron::Sie wurden geboren
heridos::verwundet
cuentan::Sie zählen
padres::Eltern
mejores::besser
amigos::Freunde
agrada::Es gefällt
intimidad::Intimität
tratan::versuchen
gruñona::Fugenmörtel
gruñonas::grunzt
disculpen::Entschuldigen Sie mich.
Tomamos::Wir trinken
casillas::Boxen
Estamos::Sind
estar::sein
Tan::Als
brillante::brillant
viste::Sie sahen
parte::Teil
estuvo::Er war
Increíble::Unglaublich
Mamás::Mütter
increíbles::Unglaublich
Contexto::Kontext
contexto::Kontext
refería::ich habe mich verwiesen
entonces::Dann
apareció::erschien
Trabajo::Job
Exhibición::Ausstellung
conectaré::Ich verbinde mich
contraseña::Kennwort
pido::Ich frage
cervezas::Biere
Perfecto::Perfekt
viejos::alte
conocidos::bekannt
soledad::Einsamkeit
idiotas::Idioten
confío::Ich vertraue
Sabés::Du weißt, dass du
largará::Er wird gehen.
fantásticas::Fantastisch
iré::Ich werde gehen.
lanzar::Start
dardos::Darts
pedir::fragen
Ataca::Angriff
ofrecen::Angebot
TV::TV
incomodan::Sie sind unbequem.
situaciones::-Situationen
ganar::verdienen
Ten::Hier gehst du
cuidado::Pflege
sonrisa::Lächeln
contagiosa::ansteckend
gustando::Geschmack
enoja::Zornig
preguntaré::Ich werde fragen
enojaría::Ich wäre wütend.
misma::sich
conocido::bekannt
agradas::Ich mag dich
preguntar::fragen
cobrar::sammeln
Hablas::Du redest
pintura::Malerei
colgar::hängen
empresaria::Unternehmer
importar::importieren
empleados::Mitarbeiter
piensen::Denken
siquiera::Sogar
invitaron::eingeladen
dejan::Sie verlassen
frase::Phrase
niña::Mädchen
soltera::Single
trabajaba::ich arbeitete
conocí::Ich habe mich getroffen
familia::Familie
honesta::Ehrlich
Consigue::Holen Sie sich es
concursantes::Teilnehmer
cuchillos::Messer
desastre::Desaster
planear::gleiten
citar::Zitat
inseguridad::Unsicherheit
doblaré::Ich werde falten
divierten::Sie haben Spaß
sobran::Es gibt viele von ihnen
noches::Nächte
entendí::Ich hab's.
llegaron::Sie kamen an
sangre::Blut
llame::Rufen Sie mich an
Novedades::Was ist neu?
cociendo::kochen
Tardará::Es dauert eine Weile
pensaba::Ich dachte
chances::Chancen
tengamos::Lassen Sie uns
sexo::Geschlecht
Buenos::Gut. Gut
quedar::treffen
acurrucar::Kuscheln Sie sich
larga::Lange
Continuará::Es wird fortgesetzt
desmayaste::Du bist ohnmächtig geworden.
llamaré::Ich rufe an.
Levanta::Steh auf
Querida::Liebling
Pasé::ich bestanden habe
di::Sagen
Necesitaba::Ich brauchte es.
caso::Fall
verdades::Wahrheiten
trío::Trio
mapaches::Waschbären
Crucé::ich überquerte
miradas::Aussehen
padre::Vater
mapache::Waschbär
Era::Ära
líder::Führer
notaba::Ich bemerkte
sensacional::sensationell
Viste::Sie sahen
comunicaste::Sie haben kommuniziert
conecté::Ich habe verbunden
tomaste::Du hast es genommen.
ayudaron::Sie halfen
Escucha::Zuhörer
envejecemos::Wir werden alt
funcione::um zu arbeiten
cambios::Änderungen
porquería::Dreck
imbécil::Dummkopf
letras::Briefe
cielo::Himmel
tarado::Blödmann
Oigan::Hey, Jungs.
quedó::Es ist übrig.
cretino::Kretin
mentiras::Lügen
pensamos::Wir denken
Levanten::Steh auf
piso::Etage
maldito::Ficken
Excelente::Ausgezeichnet
planeado::gedacht
estúpido::dumm
Quiten::Nehmen Sie es aus
esta::Dieses hier
bata::Robe
deprimente::deprimierend
Pongan::Setzen Sie es auf
vestido::Kleid
cómodo::bequem
noticias::Nachrichten
faltan::Sie werden vermisst
dos::Einstand
Anoche::Letzte Nacht
distraje::abgelenkt
ansío::Ich sehne mich
mientas::Lüge
corta::Schneiden Sie es aus
esperar::erwarten
putas::Nutten
astas::Geweih
Meteré::Ich werde reinkommen.
silla::Stuhl
ruedas::Räder
ancianos::alte Leute
comeré::Ich werde essen.
Vamos::Brei
desnivel::Klasse
abras::Öffnen Sie
final::endgültig
aparecen::erscheinen
salón::Halle
fama::Ruhm
mostrar::Display
Hicimos::Wir haben
Conseguimos::Wir haben es.
original::original
Dice::Er sagt:
precios::Preise
atendíamos::Wir haben uns darum gekümmert
copia::Kopie
mural::Wandgemälde
Comeremos::Wir essen
cestas::Körbe
origina::stammt
listo::clever
creímos::Wir glaubten
ido::weg
camiseta::Jersey
Siquiera::Ich habe es sogar getan
notaron::sie/Sie bemerkten
Intentamos::Wir haben es versucht
contactar::kontaktieren Sie uns
bienvenida::Willkommen
sincera::Ehrlich
Alquilaste::Sie haben gemietet
cuartos::Zimmer
invitada::Gast
pensé::Ich dachte
vendría::Ich würde kommen
preocupen::Sorge
notarán::wirst du bemerken
fui::ich ging
apaga::Deaktivieren Sie
aplaudiendo::Klatschen
aplauso::Applaus
sarcástico::sarkastisch
hablando::Reden
uses::verwenden
vivaz::lebhaft
perderé::Ich verliere
cordura::Verstand
aplaudes::Sie applaudieren
Aplaudo::Applaus
cumplió::Er tat es.
profecía::Prophezeiung
tiempos::mal
crees::Du denkst
invitamos::Wir laden Sie ein
dejamos::Wir verlassen
fuera::außerhalb
quedas::Du bleibst
antoja::Begierde
disculpar::Entschuldigen Sie mich.
éxito::Hit
disculpes::Entschuldigen Sie mich.
enorgulleces::Du bist stolz.
pensaste::Du dachtest
necesitemos::wir brauchen
necesitamos::Wir brauchen
necesito::Ich brauche es.
estaremos::Wir werden da sein.
sagrado::heilig
desconcertada::verdutzt
pasando::Kommen durch
pon::Setzen Sie es auf
Finalmente::Schließlich
análisis::Analyse
genético::genetisch
moriré::Ich werde sterben.
cáncer::Krebs
mama::Mama
Hice::ich tat
presentación::Präsentation
diapositivas::Folien
animará::wird aufmuntern
ahuyentará::Es wird verscheuchen
miedos::Ängste
intento::Versuch
arreglar::reparieren
diviertas::Viel Spaß
despidieron::Sie haben gefeuert
sensación::Gefühl
preguntaste::Du hast gefragt.
escuchaste::Du hast gehört.
finjamos::Tun wir so, als ob wir
sigas::Weiter geht's
sigo::ich gehe weiter
doble::doppelt
salida::Abflug
furiosa::wütend
detente::Stoppen Sie es
Dejen::Stoppen Sie es
espera::Warte, warte.
oráculo::Orakel
mamogramas::Mammogramme
miraste::Du hast geschaut
Intento::Versuch
amable::nett
diste::Du gabst
cobró::eingelöst
doy::ich gebe
cuanta::Wie viel
adulta::Erwachsene
Entonces::Nun, dann
fulminantes::fulminant
ronda::Patrouille
organización::Organisation
comporta::verhält sich
médico::Arzt
milenial::Jahrtausendjährig
atreves::Du wagst es.
serpiente::Natter
cartas::-Karten
Piedras::Steine
viejas::alt
buscamos::Wir schauen
muerta::tot
rayos::Oh, verdammt!
sensibilidad::Empfindlichkeit
pierna::Bein
levantar::Aufzug
Llamemos::Rufen wir an
brillo::glitzern
busca::Pager
encogiendo::schrumpfen
rodó::Er rollte
colina::Hügel
bajar::herunterlassen
ayudar::helfen
vinimos::Wir kamen
cae::fällt
Esquiaba::ich war skilaufen
Mantuvo::Er behielt
venenosa::giftig
puedo::Ich kann
voy::Ich komme.
carrito::Karren
quedaré::Ich bleibe hier.
pasan::Sie gehen vorbei
nubes::Eibisch
saquen::Raus
puedes::Sie können
arregló::arrangiert
Tomaré::Ich nehme es.
camino::Spur
lograste::Du hast es geschafft.
Despacio::Langsam
Llega::Es kommt
arbusto::Busch
estarás::Du wirst sein
atraparemos::Wir fangen
soltar::lockern
enfrentando::mit der Verkleidung
Atiende::Heben Sie es auf
acuerdo::Vereinbarung
tonta::Klumpen
cansada::Müde
perseguir::jagen
ambiciones::Ambitionen
vivir::leben
Colgaré::Ich werde auflegen
arrepienta::bereuen
preguntan::Sie fragen
rechacé::Ich habe abgelehnt
oímos::wir hören
vacaciones::Urlaub
elijo::Ich wähle
Asentimos::Wir nicken
envía::Senden
ambulancia::Krankenwagen
Sagrada::Heilig
Amiga::Freund
mordida::beißen
signos::Zeichen
exclamación::Ausruf
zambullida::Tauchen
cisne::Schwan
doler::verletzt
gloriosa::herrlich
crema::Creme
antibacterial::antibakteriell
definitivamente::definitiv
condescendiente::herablassend
morimos::Wir sterben
sido::gewesen
rama::Zweig
puntiaguda::spitz
pinchan::Sie stechen ein
vimos::Wir sahen
muerde::Er beißt
Deje::Stoppen Sie es
escuchan::hören
mueren::Sie sterben
paros::Stopfen
cardíacos::Herzfrequenz
sonrías::Lächeln
muerto::tot
regreso::Ich bin wieder da.
resulta::es stellt sich heraus
tobillo::Knöchel
envenenado::vergiftet
volveré::Ich komme zurück.
succiones::Saugwirkung
personalmente::persönlich
seguro::Versicherung
termines::Du bist fertig.
Maldito::Ficken
inútil::sinnlos
Llamar::Anruf
doctor::Arzt
Oficina::Büro
habla::Reden
Llamo::Ich rufe an.
segundo::letztere
imitación::Nachahmung
fueron::ging
pedos::Furzen
hijo::Kind
Sigue::Weiter geht's
ajedrez::Schach
nerd::Nerd
criar::Rasse
sabías::du wusstest
estábamos::Wir waren
emergencias::Notfälle
supuse::Ich habe erraten
pida::fragen
taxi::Taxi
llevará::wird nehmen
sabía::Ich wusste es.
usábamos::wir benutzten
borrar::auslöschen
dudas::Zweifel
Pobrecita::Armes Ding
descuento::Rabatt
costó::Kosten
planta::Fabrik
camioneta::Bus
caímos::Wir fielen
recordar::Erinnern Sie sich
conviene::es angebracht ist
alternar::alternieren
Cosas::Zeug
Absolutamente::Absolut
Dejaré::Ich werde aufhören.
queda::Ruinen
Sienta::Setz dich hin
caer::fallen
Estaciona::Ziehen Sie über
planeaste::Sie haben geplant
follé::Ich habe geschraubt
dijiste::Du sagtest:
Tuve::ich hatte
inimaginable::unvorstellbar
Estuvo::Er war
brindando::Toasten
follaron::Sie haben geschraubt
viniendo::Kommen
vamos::Brei
erré::Ich habe versäumt
canté::Ich sang
Traducción::Übersetzung
subtítulos::Untertitel
licenciatura::Bachelor
además::außer
licenciado::Bachelor
máster::Meister
Pertenecemos::Wir gehören
generación::Generation
preparada::Bereit
historia::Geschichte
economía::Wirtschaft
mundial::global
viviendo::Lebensunterhalt
abuelos::Großeltern
emigrando::emigrierend
pagando::zahlen
platos::Abwasch
rotos::Gebrochen
llaman::Sie rufen
perdida::verloren
diarias::täglich
turco::Türkisch
salgo::Ich bin raus.
oliendo::riechen
preguntando::fragen
coño::Fotze
llegar::ankommen
siesta::Nickerchen
despiertan::aufwachen
versos::Verse
poeta::Dichter
manos::Hände
Doy::ich gebe
impresión::Eindruck
corbata::Krawatte
atrevida::Wagemut
hilo::Kordel
estate::Sei da
quieto::Halten Sie die Standfesthalten
pone::es setzt
nerviosa::nervös
cuando::als
llevo::ich trage
pateando::Tritten
empresas::Unternehmen
llamaremos::Wir rufen
apellido::Nachname
ofreciendo::Angebot
llaves::Schlüssel
coche::Auto
aparque::Park
entiende::Du verstehst
princesa::Prinzessin
hombre::Mann
rana::Frosch
equivoca::Falsch
compuesto::Verbindung
valgo::Ich bin es wert
cree::Cree
contratado::angeheuert
prestigiosa::prestigeträchtig
Policía::Polizei
quietos::Halten Sie die Standfesthalten
Venga::Komm schon, komm schon.
desconecte::abklemmen
trituradora::Zerkleinerer
investigación::Untersuchung
dependen::abhängen
cultivo::Kultivierung
microscópico::mikroskopisch
científico::Boffin
mires::Aussehen
estable::stabil
Estable::Stabil
revista::Magazin
bemoles::flach
publicar::veröffentlichen
rector::Rektor
Rector::Rektor
Vaya::Oh, wow.
desempolvando::Abstauben
año::Jahr
recortes::Schnitte
becas::Stipendien
director::Regisseur
financiero::finanziell
relacionar::Link
error::Fehler
entrevistó::interviewt
sacado::heraus
contabilidad::Buchhaltung
letra::Brief
vale::OK
Exijo::ich fordere
explicación::Erklärung
investigado::untersucht
posibilidades::Möglichkeiten
Tranquiliza::Beruhigen Sie sich
Pues::Für
mira::Aussehen
tranquilizo::Beruhigen Sie sich
beca::gewähren
hacéis::du machst
abandonar::aufgeben
dedicado::dediziert
comer::essen
podido::Ich könnte
echar::entlassen
Hombre::Mann
tendremos::Wir werden
manifestamos::wir manifestieren
recoger::sammeln
firmas::Signaturen
llamamos::Wir riefen
cigalas::Krebs
pasado::Vergangenheit
clase::Klasse
media::Durchschnitt
comida::Lebensmittel
entrado::im
mercado::Markt
laboral::Arbeit
puñetera::Verdammtes Ding
calle::Spur
jefe::Chef
malentendido::Missverständnis
fiscal::Fiskalpolitik
malversación::Unterschlagung
fondos::Geldmittel
evasión::Ausweichen
capital::Kapital
delito::Kriminalität
hacienda::Hazienda
pública::Öffentlichkeit
finiquito::finiquito
dan::Dan
Pobre::Mager
rezo::Ich bete
novena::neunte
trabajador::fleißig
rezando::beten
cola::Cola
milagros::Wunder
empaquetamos::wir packen
devolver::Rückkehr
mar::Meer
invitar::einladen
brun::Brun
bruche::Hexe
paleta::Farbpalette
esforzando::hart arbeiten
patada::kicken
ciencia::Wissenschaft
únicos::einzigartig
investigan::Untersuchen
jueces::Richter
preparación::Vorbereitung
invertido::rückwärts
necios::Narren
desaprovechar::Abfall
anda::Komm schon.
buscan::Suche
reponedores::Raffinerien
arreglan::Sie beheben
futuro::Zukunft
suicidaba::Selbstmord
emigraba::emigrierte
aprensivo::besorgt
elegiste::Sie haben sich für
clima::Klima
vive::Er lebt
encontrado::gründen
daba::gab
viendo::beobachten
tele::TV
despacio::Langsam
tío::Kerl
prisas::in Eile
alemanes::Deutsche
chollo::Schnäppchen
cualificada::qualifiziert
costa::segeln
ejemplo::Beispiel
especializado::Brauch
gestión::Management
medioambiental::Umwelt
residuos::Abfall
piensas::Du denkst
ganaras::Sie werden gewinnen
mes::Monat
mueven::Bewegen
judíos::Jude
visto::gesehen
Parecía::Es schien
digo::Ich meine
cualificado::qualifiziert
invierten::investieren
talento::Geschenk
nota::Notiz
inventado::erfunden
imprenta::Druckmaschine
motor::Motor
aspirina::Aspirin
aportación::Beitrag
fregona::Dienstmädchen
mandan::Sie sind verantwortlich.
intermediarios::Vermittler
pudiendo::in der Lage zu sein
cortan::Sie schneiden
bacalao::Kabeljau
par::Paar
animamos::wir jubeln auf
Bienvenidos::Willkommen zurück
milagro::Wunder
alemán::Deutsche
Hostias::Heiliger Mist
afectado::affektiert
calentamiento::Heizung
global::global
venido::Kommen
dirección::Richtung
casero::hausgemacht
dado::sterben
limosna::Almosen
contado::gezählt
españoles::Spanisch
cambien::Ändern
hostia::Gastgeber
capullo::Kokon
capulla::Kokon
española::Spanisch
Española::Spanisch
maleducada::unhöflich
aparca::Park
bici::Fahrrad
disculpado::Es tut mir leid.
Disculpar::Entschuldigen Sie mich.
mitad::Hälfte
carril::Spur
pintado::bemalt
dibujitos::Kleine Zeichnungen
roto::gebrochen
tíos::- Jungs
tenéis::werdet haben
jodiendo::verschrauben
oye::ey
tranquila::Mach dir keine Sorgen.
contenta::Glücklich
pagues::bezahlen
borde::Kante
Olvida::Vergiss es
brazos::Arme
abiertos::öffnen
billetes::Eintrittskarten
ponía::Ich habe es gesagt.
alquila::Mieten
habitaciones::Zimmer
encargado::Verantwortlich
chaval::Kind
esguince::Verstauchung
lengua::Sprache
Sois::Sind
podéis::Sie können
colocar::Ort
rollo::Seitensprung
vais::Du gehst
maría::Maria
keta::Keta
speed::Speed
cristal::Kristall
lleváis::Du trägst
gramitos::Gramm
tercero::dritte
habitación::Schlafzimmer
Buscamos::Wir suchen
llegado::angekommen
puntito::Punkt
poniendo::Putting
gafitas::Brille
pavos::Bock
ratito::Eine kleine Weile
venimos::Wir kommen
buscando::auf der Suche
niño::Kind
perdido::verloren
haciendo::Tun
lorcitas::Loritas
mofletes::Moffletes
cositas::Kleinigkeiten
preguntado::gefragt
Perdone::Oh, entschuldigen Sie mich.
Venimos::Wir kommen
santo::heilig
líquido::Flüssigkeit
saliva::Speichel
Acabado::Beenden
Habitación::Schlafzimmer
perro::Hund
ovulación::Ovulation
fase::Phase
lútea::Lutea
temperatura::Temperatur
basal::basal
espermatozoides::Spermium
acompañe::Kommen Sie mit
compañero::Partner
pasote::Pasote
Tenéis::Sie haben
champú::Shampoo
jodas::Fickt
compañeros::Kameraden
tenido::hatte
Vais::Du gehst hin.
edificio::Gebäude
Tendríais::Sie sollten
puso::legen Sie es
semanas::Wochen
tardé::Ich war spät dran
enterar::finden Sie heraus
ganado::Vieh
Lleva::Nehmen Sie es
traigo::ich bringe
insistas::bestehen
grifa::Greif
colegas::Kollegen
emigran::emigrieren
cambiar::ändern
países::Ländern
emigrantes::Emigranten
propiedad::Besitz
diría::Ich würde sagen,
trabajadores::Arbeit
cualificados::qualifiziert
Fija::Fixiert
puestos::Beiträge
sois::sind
gilipollas::Arschloch
Oiga::He, hey.
faltar::verpassen
necesidad::brauchen
Necesidad::Brauchen
sabréis::ihr würdet wissen
hacinado::überfüllt
tren::Zug
vivido::gelebt
barracón::Etagenhaus
trabajado::funktionierte
paséis::Kommen Sie rein
parecido::gleichermaßen
emigrar::emigrieren
mimados::verwöhnt
gracia::Gnade
cabrón::Bastard
meses::Monate
principito::Kleiner Prinz
duras::schwer
bienvenidos::Willkommen
enfrente::Gegenteil
cosica::Kosika
comentéis::Kommentar
business::Geschäft
pastillas::Pillen
preocupar::Besorgnis
trajo::mitgebracht
empezando::Erste Schritte
coquetear::flirten
follando::verschrauben
arreglas::Du behebst es
Hostia::Gastgeber
conocéis::ihr wisst
tensión::Spannung
Perdonad::Entschuldigen Sie mich.
hecha::Fertig
polvo::Staub
come::Essen
salchichas::Würstchen
chuleado::gekühlt
prometió::versprochen
mirad::Aussehen
interese::Interesse
anterior::ersterer
flipar::Spiegeln
Van::Sie gehen
entrevistas::Interviews
de::von
paciencia::Geduld
necesitar::brauchen
tendrá::werden haben
contrate::mieten
carreras::Rennen
listilla::Clutsy
tengas::Haben Sie es
tía::Tante
maja::nett
sondeable::Kann sondierbar werden
gafotas::Brille
has::Sie haben
cuerpazo::Körper
anatomía::Anatomie
desapercibida::unbemerkt
intentes::Versuchen
huevos::Eier
bolitas::Palls
antiestrés::Anti-Stress
clarinete::Klarinette
quedado::links
Tíos::- Jungs
estornudado::niesen
papá::Papa
todo::alles
hueco::hohl
mandar::Befehl
empezado::gestartet
primeras::zuerst
currículum::Zusammenfassung
rifan::Rifan
marca::Marke
abre::Öffnen Sie
puertas::Türen
Parece::Sieht so aus
solo::nur
adaptado::anpassen
carácter::Charakter
latinos::Latein
besucones::Küsse
cabo::Kap
diferencias::Unterschiede
Norte::Norden
Ni::Noch
somos::sind
informa::Berichte
cuadriculados::Raster
metro::Metro
cortesía::Höflichkeit
idioma::Sprache
llevas::Du trägst
oído::Ohr
decisión::Entscheidung
tomado::vergeben
dejado::links
últimos::zuletzt
fila::Linie
griegos::Griechen
portugueses::Portugiesisch
italianos::Italiener
curro::Job
Hakan::Herr Hakan
desesperado::verzweifelt
pinches::Kneifen
encuentra::findet
solución::Lösung
Puta::Nutte
títere::Marionette
macho::männlich
buscas::Sie suchen
busques::Suche
hombres::Menschen
Vale::OK
pintan::malen
economista::Ökonom
entrar::eingeben
estudio::Etüde
arquitectura::Architektur
limpié::Ich habe aufgeräumt
escaleras::Treppe
camas::Betten
respetable::würdevoll
expectativas::Erwartungen
ecuatoriana::ecuadorianisch
limpiaba::aufgeräumt
hacía::ich tat
sueño::Traum
pequeñita::Kleines
narices::Nase
servir::nützen
guiris::Guiris
quedo::ich bleibe
chiringuito::Snackbar am Pool
oiríamos::wir hörten
quejar::stöhnen
preocupes::Sorge
oír::hören
coger::fangen
antro::Höhle
asco::Ekel
cliente::Klient
durado::dauerte
caja::Box
quisqui::Quickie
porra::Taktstock
cabrones::Bastarde
sabéis::Du weißt, dass du
quedáis::Du bleibst
maravilloso::wunderbar
pusiste::Du hast es gesagt.
será::wird sein
deseando::Ich wünschte
llegue::Ich bin angekommen
agosto::August
Hijo::Kind
ricos::reich
nada::nichts
parientes::Verwandten
minijobs::Minijobs
boyantes::schwimmfähig
estarán::wird sein
debe::müssen
roba::Er stiehlt
levantamos::Wir stehen auf
fatal::tödlich
transferencia::Übertragung
mayo::Kann
sacas::Du nimmst heraus
tema::Thema
dejando::Verlassen
lleven::Machen Sie eine Fahrt
capear::Wetter
capeamos::Wir capeate
echado::weggeworfen
comprado::gekauft
rastrillo::Harke
benéfico::Wohltätig
marcas::Markierungen
aguanto::Ich kann aufhängen.
acabar::beenden
donando::Spenden
comente::Kommentar
desahucio::Räumung
desahucian::Räumung
pagada::bezahlt
tuvimos::wir hatten
hipotecar::Hypothek
reproche::Vorwurf
agarrar::greifen
decías::Du wolltest sagen.
estaban::waren
hostias::Jesus Christus
contratar::mieten
Venir::Kommen
insultar::beleidigen
decidido::entschieden
local::lokal
preocupéis::Sorge
mando::Befehl
perdono::Es tut mir leid.
parto::Geburt
servicio::Annehmlichkeit
ofrecer::Angebot
concretado::betoniert
sueldo::Gehalt
gratis::frei
decía::Ich habe gesagt
economistas::Ökonomen
limpiamos::Wir bereinigen
creativa::kreativ
ríes::Lachen
patético::erbärmlich
desahuciar::Räumung
tragar::Schluck
orgullo::Stolz
Empiezas::Du fängst an
freír::braten
falafeles::Falafeles
responsabilidad::Verbindlichkeit
requiere::erfordert
alta::Entladung
cualificación::Qualifikation
asuntos::zählt
delicados::zart
condiciones::Bedingungen
horario::Zeitplan
flexible::flexibel
saca::Nehmen Sie es heraus
dietas::Diäten
hasta::sogar
vehículo::Fahrzeug
gama::Farbskala
Cómodo::Bequem
nivel::Niveau
creemos::Wir glauben
pediste::Du hast gefragt.
gano::ich gewinne
cerrar::schließen
cartera::Handtasche
dudes::Sie zweifeln
Pensar::Denken
hubiésemos::würden wir haben
choque::Zusammenstoß
culturas::Kulturen
llamado::Anruf
basurero::Müllkippe
engorda::Es wird fett
cobrando::Aufladen
miseria::Elend
querías::Du wolltest das
desgraciado::Bastard
dijera::Ich sagte:
estudiando::Studium
sacar::zeichnen
Información::Information
verstehe::Verstehe
costará::wird kosten
vocales::Vokale
kardash::Kardash
sueltas::Lass uns gehen.
dientes::Zähne
mantén::Halten Sie auf
bebida::trinken
gaseosa::Soda
torpe::ungeschickt
acojonar::Ausflippen
comunicar::kommunizieren
pide::fragen
convocan::beschwören
título::Beschriftung
presentar::einführen
Tranquilo::Friedlich
profesor::Professor
das::Du gibst
clases::Klassen
enseñé::ich unterrichtete
español::Spanisch
oveja::Mutterschaf
gallo::Hähnchen
enmarcando::Einrahmung
despacho::versenden
directivo::Manager
secretaria::Sekretärin
cuarta::vierte
Manda::Er ist verantwortlich.
Encima::Oben
subir::klettern
tacones::Fersen
vea::Sehen
queen::Königin
meter::einfügen
currar::Arbeit
profundidad::Tiefe
Corre::Komm schon, lauf.
prepara::Vorbereiten
quieras::Sie möchten
cagues::Cuck-up
supercuqui::Supercuqui
mueve::Bewegen
cámara::Kamera
vistas::Ansichten
Tampoco::Entweder
creas::du denkst
tiran::Sie ziehen
montón::Strauß
hablas::Du redest
guapa::schön
Guapa::Schön
celosa::eifersüchtig
dejo::ich kündigte
presidente::Vorsitzende
compañía::Unternehmen
beso::küssen
animal::Tier
tarados::Ihr Schwachkopf
metido::neugierig
disfrazado::verkleidet
alto::hoch
atractiva::attraktiv
finja::Vorgeben
explicaciones::Erklärungen
aguantar::halten
leccioncitas::kleine Lektionen
doña::- Dona
Va::Oh, komm schon.
pagado::bezahlt
másteres::Master-Abschlüsse
educación::Bildung
triunfador::triumphieren
mirarían::würde aussehen
golf::Golf
enteran::Sie finden es heraus
trabaja::Er arbeitet
pinche::Ficken
Club::Klub
sobrado::links
manda::Es ist Boss.
teutona::Der Teuton
fichada::Datei
peores::Schlimmer
plazas::Quadrate
toreado::Tored
fumado::geräuchert
culito::kleiner Hintern
embarazada::schwanger
Embarazada::Schwanger
embarazo::gebärfähigen
saquemos::Lass uns raus.
ofenda::Vergehen
virilidad::Männlichkeit
puñetero::Verdammter Mann
oyes::Du hörst
gira::Drehen Sie sich um
prueba::Beweismittel
fertilidad::Fruchtbarkeit
mire::Aussehen
álbum::Album
familiar::Familie
elegir::wählen
sales::Du gehst aus
perdiendo::Verlieren
colocando::Platzieren
enfrentaremos::wir werden anschanken
examinador::Prüfer
duro::schwer
pueblo::Menschen
Lección::Lektion
billete::Banknote
aclaramos::wir klären
ocurrió::Es geschah
avanzo::ich schaue voran
septiembre::September
limpiando::aufräumen
grasa::Fett
cordero::Lamm
olvide::Vergiss es
academia::Akademie
centre::Zentrum
esfuerzos::Bemühungen
preñar::schwanger
Clases::Klassen
ojo::Auge
molestia::Ärgernis
gasto::Aufwand
estas::Diese
Tiempo::- Und eine Weile
discuto::Ich streite
corrigen::korrigieren
enseñe::ich unterrichte
regiones::Regionen
pedo::Furz
halla::finden
cerveza::Bier
alemana::Deutsche
fuertecita::stark
aparece::wird angezeigt
honra::Ehre
presencia::Anwesenheit
pies::Füße
alteza::Hoheit
sujeta::Halten Sie auf
moza::Magd
barrio::Nachbarschaft
Viajar::Reise
Estando::Stehen
jubilado::im Ruhestand
residencia::Bleibe
desagradecida::undankbar
adaptaba::angepasst
adaptar::anpassen
salí::Ich bin rausgestiegen
pasaba::ich habe geschwaufen
acordaba::vereinbart
olvida::Vergiss es
condenado::verurteilt
repetir::Duplikat
si::wenn
puñetas::Verdammt!
oís::Hey, hör zu.
estará::wird sein
verás::Sie werden sehen
acuerda::zustimmen
perdona::Es tut mir leid.
llegó::Er ist hier.
ampollas::Blasen
aplaudir::applaudieren
reiría::Ich würde lachen
imaginaba::Ich stellte mir vor
encontramos::Wir fanden
trae::Bringen Sie es
ayude::Helfen Sie mir
toalla::Handtuch
entrenando::Ausbildung
correr::Kurs
conseguido::Ich habe es.
terminar::beenden
todavía::noch
zapatillas::Pantoffeln
extraña::Seltsam
agarrada::- Greift
gasta::Verbringen
dinerito::Wenig Geld
rascar::Kratzer
plancha::Eisen
extras::Extras
espaguetis::Spaghetti
alegro::Ich bin froh.
subrayo::ich unterstreiche
Habló::Er sprach:
emigración::Auswanderung
aprenderéis::du wirst lernen
resolveros::Lösen Sie sich
maratones::Marathons
cagando::Kotschen
col::Kohl
fermentada::fermentiert
echas::Du wirfst raus
dieta::Diät
mediterránea::mediterran
Mil::Großartig
euros::Euro
trimestre::Quartal
curso::Kurs
escuchando::Zuhören
llevaba::Er trug
lloviendo::Es regnet
baboso::Schwachkopf
entienda::Verstehen
puedas::Sie können
meto::ich komme rein
ahorro::Einsparungen
digestión::Verdauung
empieces::Du startest
aprendiste::Du hast gelernt
Si::Wenn
pasaste::Du hast bestanden
entero::Ganzzahl
yendo::gehen
psicólogo::Psychologe
gordo::Fett
dirás::du meinst
Enterar::Finden Sie es heraus
invitados::Gäste
cuernos::Hörner
saco::Tasche
caracoles::Mensch
Resulta::Es stellt sich heraus
novios::Freunde
mío::meins
tausend::Tausend
famoso::berühmt
parecen::Sie sehen aus wie
piden::fragen
dando::geben
lecciones::Lektionen
austeridad::Austerität
maneras::Wege
pasta::Paste
pague::bezahlen
masturbar::masturbieren
pintas::Du malst
uñas::Nägel
pones::Sie setzen
anillicos::Anillicos
leche::Milch
botecito::kleines Boot
pagar::bezahlen
hidratante::Feuchtigkeitsspendend
carne::Fleisch
viva::Lebendig
lío::Ärger
enterado::Ich weiß es.
investigadores::Forscher
cabe::Es passt
majaderías::Weißt du, verrückte Dinge
ideas::Ideen
ríete::Lachen
subvenciones::Subventionen
científicos::Wissenschaftler
recurrir::Resort
eyaculaciones::Ejakulationen
rindo::ich gebe auf
vuelvo::Ich komme zurück.
Prefiero::Ich bevorzuge
renunciar::aufgeben
vocación::Berufung
dignidad::Würde
pago::Zahlung
paga::bezahlen
marido::Ehemann
especie::Spezies
vendes::Sie verkaufen
baratos::billig
compro::ich kaufe
precio::Preis
permitir::erlauben
saltamos::Wir springen
intermediario::Zwischenhändler
loca::Verrückt
deseas::Sie wünschen
investigador::Ermittler
ocurre::Es passiert
elegante::elegant
cena::Abendessen
baja::Unfallopfer
arropar::Einstecken
golondrinas::Schwalben
alzhéimer::Alzheimer
olvidaba::Ich vergaß
mismas::sich
tomaba::ich habe getrunken
abuela::Großmutter
chorizo::Chorizo
jamón::Schinken
currado::funktionierte
papás::Väter
echo::Echo
fechas::Datumsangaben
unida::vereint
Nochebuenas::Heiligabend
sacando::herausnehmen
cuartelillo::Kaserne
juntos::zusammen
toquecillo::Tuddling
rioja::Rioja
potingue::Potingue
navidades::Weihnachten
pasamos::Wir bestanden
mete::Holen Sie sich ein
follen::Schraube
Follar::Ficken
insinuando::anmutigend
tardar::dauern eine lange Zeit
mesa::Tafelberg
Sobra::Übrig
plato::Gericht
Diga::Hallo
nacer::entstehen
peinando::Kämmen
pandereta::Tamburin
veía::Ich sah
olla::Topf
polla::Schwanz
alegría::Freude
cosita::Kleines Ding
tocado::Kopfbedeckung
sirve::Es ist gut.
consuelo::Trost
sepas::Du weißt, dass du
cuenten::Zählen
diferentes::anders
juré::Ich habe geschworen
colegio::Berufsfachschule
invitó::eingeladen
funciona::Es funktioniert
promete::Versprechen
pereza::Faulheit
iban::sie/Sie haben mitgemacht
cole::Cole
animé::Ich jubelte
compré::ich kaufte
peluquería::Friseurgeschäft
recogieran::abholen
iglesia::Kirche
ilusionada::aufgeregt
chaqué::Chaqué
casaba::ich habe geheiratet
pronto::Bald
casar::heiraten
quedarías::du würdest bleiben
ramo::Bouquet
Cogiste::Du hast es.
cayó::fällen
lloraba::ich habe geweint
emoción::Emotion
dejas::Du gehst
ceremonia::Zeremonie
esperando::anhängig
estés::du bist
tenías::Du hattest
molestado::verärgert
preciosas::schön
riñón::Niere
perfectamente::perfekt
cocina::Küche
digamos::Sagen wir mal.
remediar::Heilmittel
presento::ich präsentiere
turística::Tourist
Prepara::Machen Sie sich bereit
Tuvo::Er hatte
aterricé::Ich bin gelandet
porvenir::Zukunft
suspenso::Schwebezustand
feo::Hässlich
parlamento::Parlament
Precioso::Süß
cúpula::Kuppel
diseñada::entworfen
cono::Kegel
reflector::Reflektor
diseñado::entworfen
dirigir::direkt
solamente::nur
elemento::Element
arquitectónico::architektonisch
valiente::mutig
medias::Strümpfe
discurso::Diskurs
boca::Mund
susto::Schreck
reunificación::Wiedervereinigung
restauraron::restauriert
cuadriga::Streitwagen
salido::Heraus
Preciosa::Oh, schön.
bonito::nett
pareja::Paar
chorrada::Fleischwurst
entra::Kommen Sie rein
arena::Arena
brindaron::Sie toast
casualidad::Chance
Coge::Nehmen Sie es
zanjar::siedeln
engañar::täuschen
Sabíamos::Wir wussten
relaciones::Beziehungen
complicadas::kompliziert
conoce::weiß
Porno::Porno
parejas::Paare
abeja::Biene
liar::rollen
mosquita::kleine Fliege
conociendo::Kennenlernen
Conociendo::Kennenlernen
agarras::Du schnappst es.
guarra::Schlampe
orejas::Ohren
coges::Du nimmst
empiezas::Du startest
cante::Singen
hermano::Bruder
psicópata::Psycho
libido::Libido
bajo::niedrig
escapado::entkommen
momentito::Momentito
noticia::Nachrichten
pichabrava::Pichabrava
Emocionada::Aufgeregt
entendido::Ich habe es.
emocionada::aufgeregt
Calla::Halt die Klappe.
o::oder
rabo::Schwanz
Mal::Böse
Menudo::Ändern
complicar::komplizieren
sospechar::vermuten
fundita::Schmilzt
venga::Komm schon, komm schon.
decid::Sagen
contento::glücklich
multinacional::multinationale
Tío::Kerl
agobies::Agobies
entienden::Du verstehst
gastado::beunruhigt
servido::serviert
inventar::erfinden
sientan::Setz dich hin
orgullosos::stolz
envidia::Neid
repitiendo::Wiederholung
Emigrar::Emigrieren
pasábamos::Wir sind vorbeigefahren
creéis::du glaubst
contábamos::Wir haben gezählt
Trabajábamos::Wir haben gearbeitet
esclavos::Sklaven
alquiler::mieten
cargados::geladen
regalos::Geschenke
que::können
felices::Glücklich
compensaba::kompensiert
tirábamos::Wir haben geworfen
documentos::Dokumente
proyecto::zeichnen
efusivo::überschwänglich
labios::Schamlippen
colágeno::Kollagen
guapo::stattlich
tratamiento::Behandlung
ilusión::Illusion
Precisamente::Präzise
hablaros::sprechen Sie mit Ihnen
preparado::Bereit
chófer::Chauffeur
simular::simulieren
encender::entfachen
compiuter::Compiuter
bulto::Ausbuchtung
Bulto::Ausbuchtung
pegas::Du hast getroffen.
zanjemos::Lassen Sie uns begleichen
discusión::Diskussion
estéril::unfruchtbar
Estéril::Unfruchtbar
Como::Wie
pillar::bekommen
van::Gehen
dejaría::Ich würde gehen
convencer::überzeugen
harías::würdest du
enton::- Ja, Sir.
ayudas::helfen
orgulloso::Stolz
avergonzar::Peinlich
delante::vorne
silfil::Silfil
restregar::Schrubben
urbanización::Urbanisierung
alardear::prahlen
Patata::Käse
guapos::stattlich
traído::- Ich habe mitgebracht
tendido::liegend
puente::Brücke
hispanogermanas::Hispanogermanas
saques::Raus
atacada::angegriffen
soñaba::Ich träumte
deje::Lassen Sie los
paloma::Taube
llegan::Sie kommen
recepcionista::Empfangsdame
dibujo::Zeichnung
animado::lebhaft
españolo::Spanisch
Permita::Lass uns gehen.
comercial::kommerziell
Perdonen::Oh, entschuldigen Sie mich.
enterrar::begraben
Enhorabuena::Glückwunsch
cheque::Scheck
recorte::Zeitungsausschnitt
Encantada::Erfreut
Hermana::Schwester
hermanos::Brüder
bodas::Hochzeiten
aburrida::langweilig
camello::Kamel
amplío::breit
negocio::Geschäft
limusinas::Limousinen
consciente::bewusst
robado::gestohlen
guapito::stattlich
Guapito::Oh, gut aussehend
profe::Lehrer
pedido::Bestellung
tardes::nachmittags
excusa::Ausrede
celoso::eifersüchtig
entere::Ich habe herausgefunden
pegando::Kleben
espaldas::zurück
quicio::Naw
ponías::Sie setzen
dabas::Dabas
lleves::Nehmen Sie es
personal::Personal
a::bei
hablaba::ich habe geredet
ale::Ale
situación::Bedingung
embarazosa::peinlich
otra::andere
pusimos::wir setzen ein
particular::besonderer
secretarias::Sekretärinnen
patitas::Pfoten
juntar::versammeln
capullos::Kokons
despide::Feuer
descarada::frech
cortamos::Wir schneiden
ladrones::Diebe
adúlteros::Ehebrecher
acostaría::Ich würde mich hinlegen
hubiese::würde es sein
Calma::Beruhigen
líos::Ärger
violencia::Gewalt
besas::Du küsst
Invitar::Einladen
atajo::Verknüpfung
sueltes::Lassen Sie los
Cree::Cree
crea::erstellt
engañado::getäuscht
dolió::Es hat weh getan
puñetazos::Schläge
decepción::Enttäuschung
aventura::Abenteuer
pesar::Kummer
vuelto::ändern
fracaso::Versagen
olvidar::vergessen
prometer::versprechen
respeto::Respektlosigkeit
proyectos::-Projekte
convertido::konvertiert
imprescindible::unverzichtbar
uña::Fingernagel
seremos::wir werden sein
rosa::Rosa
veas::Sehen
complicado::kompliziert
preparar::reparieren
gustan::wie sie
mezclas::Mischungen
incluido::einschließlich
sucesión::Abfolge
momentos::Momente
kilómetro::Kilometer
pareces::Du siehst so aus
etíope::äthiopisch
escrito::geschrieben
Llevo::ich trage
iguales::gleich
tripa::Bauchgefühl
duchando::duschen
acompañar::begleiten
preparto::Ich bin bereit
debes::Sie müssen
cuentas::Konten
intención::Absicht
ocurra::es passiert
pisar::Schritt auf
ensartado::aufgereiht
palo::Klub
vueltas::ändern
tiras::Streifen
levantáis::Sie heben sich auf
Fácil::Einfach
primos::Cousins
hablan::Sie reden
herencia::Erbe
sienta::Setz dich hin
jovencito::Junger Mann
follón::Scheißkerl
pare::Stoppen Sie es
quejando::sich beschweren
suspender::Vertagung
banquete::Bankett
Verás::Sie werden sehen
juntando::Zusammenkommen
llego::Ich bin hier.
salario::Gehalt
mínimo::Minimum
echó::warf raus,
justificación::Rechtfertigung
dejaste::Du hast gekündigt
Preguntas::Fragen
superado::Überholt
pobre::mager
levanta::Steh auf
enamorar::verlieben sich
nombra::benennen Sie es
sueños::Träume
gustado::Ich mochte es.
corriendo::Laufen
ayudando::helfen
abierto::öffnen
salimos::Wir gehen aus
volando::in der Luft
valer::wert zu sein
ironía::Ironie
huyendo::auf der Flucht
consumiendo::konsumieren
insultaba::beleidigt
diario::täglich
acuerde::Okay, okay.
relación::Bekanntschaft
creía::Ich dachte
próxima::neben
reconozca::erkennen
arrepentir::bereuen
resto::Rest
Selección::Wahl
clasificar::klassifizieren
jornada::Reise
liga::Liga
ra::Ra
aguantas::Du hältst dich an
pegues::Hit
braguetazo::fliegen
celebra::feiert
edición::Ausgabe
paralizada::gelähmt
batido::Milchshake
récord::Datensatz
participantes::Teilnehmer
organizando::Organisieren
nervios::Nerv
propios::besitzen
sopesar::wiegen
pros::Profis
contras::Nachteile
portado::portiert
techo::Decke
firmar::Mitunterzeichner
plan::Plan
pensiones::Renten
querido::lieber
estudios::Untersuchung
apartamento::Wohnung
Acabar::Beenden
hipoteca::Hypothek
levanto::ich steh auf
pecho::Brust
respirar::atmen
Veo::Ich sehe
apretado::beengt
gobierno::Regierung
impuesto::Steuer
felicidad::Glück
buenos::Gut
Vive::Er lebt
Viva::Lebendig
prometes::Du versprichst
fiel::treu
alegrías::Freuden
penas::Sorgen
salud::Gesundheit
enfermedad::Krankheit
amar::Liebe
respetar::Ehre
obispado::Bistum
caben::sie/Sie passen an
casullas::Kaseln
cuido::Ich kümmere mich darum
tiquismiquis::Tiquismiquis
íbamos::Wir haben mitgemacht
entender::wahrnehmen
siguiese::weiter gehen
engañando::Betrügen
abogado::Anwalt
estaréis::du wirst sein
hipotecas::Hypotheken
hipoteques::Hypotheken
resumidito::in Kürze
próspero::wohlhabend
verano::Sommer
pior::schlimmer
reforma::Reform
trabajó::funktionierte
cuchillo::Messer
cortar::geschnitten
cerdo::Schwein
saltes::Springen
supieras::du wusstest
Nacen::Sie sind geboren.
entierro::Begräbnis
cabezón::großer Kopf
llega::Es kommt
aguas::Wasser
embarque::Einschiffung
cierra::Halt die Klappe.
cho::Cho
Última::Zuletzt
vuelo::Flug
Llamad::Rufen Sie mich an
entran::Sie kommen rein
obras::Arbeiten
bus::Bus
punta::Kopf
furgoneta::Lieferwagen
socarrat::Socarrat
sirvo::ich diene
terraza::Deck
oiga::He, hey.
segundos::Nachschlag
aterrizaremos::Wir landen
plegar::falten
bandeja::Tablett
aterrizar::Land
comandante::Kommandant
tripulación::Besatzung
volar::fliegen
atasco::Marmelade
ladrón::Gauner
condición::Bedingung
refranero::Sayer
castellano::Kastilisch
enseñar::lehren
Normal::Normal
diera::geben
recuerdes::Denken Sie daran
hacías::Du hast es getan.
pan::Brot
pita::Agave
Queréis::Sie möchten
parir::liefern
pariendo::gebären
llegamos::Wir sind hier.
contracciones::Kontraktionen
miro::ich schaue
Exactamente::Genau
contracción::Kontraktion
seguidas::in einer Reihe
Echar::Entlassen
partida::Abflug
cacharro::Klapperkiste
maternidad::Mutterschaft
gana::Wunsch
morderás::Du wirst beißen.
tranquilos::Nehmen Sie es einfach
flipad::Flipad
frac::Frack
parecía::sah so aus
llegas::Sie kommen an
coña::Oh, verdammt!
fija::fixiert
dilatación::Dilatation
queriendo::wollen
corredores::Läufer
coñazo::Du weißt, du weißt, dass du
lleno::voll
Pregunta::Frage
tires::Ziehen
tira::Ziehen
pinza::Klemme
dedos::Finger
girar::Ecke
cuello::Hals
hombro::Schulter
faltaba::Ich wurde vermisst
nació::geboren wurde
Empuja::Schieben
empuja::Schieben
llores::Du weinst
ayudado::geholfen
recuerdo::Andenken
imborrable::unauslöschlich
presentado::präsentiert
recorrido::Tour
buscado::gewünscht
enamorado::Liebhaber
trancas::Trancas
norte::Norden
fríos::kalt
pero::aber
reconocer::zugeben
terminado::fertig
acabado::beenden
Felicidades::Oh, herzlichen Glückwunsch
calambres::Krämpfe
saltaría::Ich würde springen
colgado::Henker
empastes::Füllungen
besado::geküsst
fuiste::Du bist gegangen.
inaguantable::unerträglich
vienes::Du kommst.
besar::küssen
puede::Sie können
demostrar::demonstrieren
miento::ich lüge
Elegí::ich wählte
aprendí::Ich lernte
luchas::Du kämpfst
recompensando::belohnend
sinvergüenzas::Schurken
Casas::Häuser
proponer::vorschlagen
formando::Formung
cambiado::geändert
siendo::Wesen
repite::Wiederholen
tragedia::Tragödie
farsa::Farce
formamos::wir bilden
chiste::Witz
pringando::Saugen
compres::kaufen
lotería::Lotterie
animar::animieren
soltura::Lockerheit
idiomas::Sprachen
cogido::Ich habe es.
hao::Hao
nis::Nis
nauma::Nauma
nao::Nao
mana::Mana
rollitos::Rollen
primavera::Frühjahr
comido::gegessen
pegado::festgefahren
cogiendo::Fangen werden
Lalío::Lalius
bra::Bh
Pelo::Haar
Profesor::Oh, Professor.
chino::Chinesisch
huesos::Knochen
ansiada::sehnte sich nach
árbol::Baum
sombra::Gespenst
almohada::Kissen
pierde::Er verliert
circular::Rundschreiben
araña::Spinne
tela::Stoff
arropó::versteckt in
controla::-Steuerelemente
pulso::Puls
rondas::Runden
esconder::verstecken
certeza::Gewissheit
ternura::Zärtlichkeit
refiero::Ich meine
anillo::Ring
fecha::Datum
Pronto::Bald
sigamos::Lasst uns weitermachen
cortemos::Lassen Sie uns schneiden
pierdas::verlieren
calmas::Beruhigen Sie sich
presionar::drücken
espontánea::spontan
pidas::fragen
Solo::Nur
vayas::Gehen
pegué::ich schlug
cuñada::Schwägerin
aniversario::Jahrestag
acuerdas::Denken Sie daran
Amor::Liebe
verduras::Blattgemüse
quitar::entfernen
cuñis::Schwedlies
Volviste::Du bist wieder da.
dé::geben
perdió::Er verlor
suficientes::Genug
hermosas::schön
niñas::Mädels
felicidades::Glückwunsch
trajimos::Wir brachten
regalito::kleines Geschenk
cortó::Er schnitt
términos::Begriffe
prácticos::praktisch
dieron::gab
haber::haben
cortado::geschnitten
ahorita::Jetzt sofort
casada::Verheiratet
salada::salzig
Anita::Ach, Anita
mona::Süß
alturas::Höhen
encontrará::wird finden
Fuimos::Wir gingen
japonés::japanisch
sospechas::Verdacht
imaginé::Ich dachte mir
galleta::Cookie
hincó::Er schwillte an
Significa::Es bedeutet
primas::Prämien
onda::Welle
comprometiste::Du hast kompromittiert
dieran::geben
secreto::obskur
enamoramos::Wir verliebten uns
engañas::Du betrügst
gato::Katze
encerrado::beigefügt
metí::Ich bin reingekommen.
hoyo::Loch
mamaste::Du hast gesaugt.
celebrando::Feiern
llevamos::Wir tragen
voz::Stimme
conquistó::erobert
horneaba::gebacken
brownies::Brownies
maravillosos::wunderbar
finalmente::schließlich
atrapó::gefangen
casados::Verheiratet
teníamos::Wir hatten
escuinclas::Schule
greñudas::Greñudas
peleoneras::Kämpfer
Peleoneras::Kämpfer
añadir::hinzufügen
rollazo::Überroll-over
Presta::Lan
felicitar::gratulieren
cañón::Kanone
metió::Er kam in die
injusta::unfair
felicitando::gratulieren
prima::Cousin
perdedora::Verlierer
primita::Kleiner Cousin
quitas::Du nimmst weg
esperanza::Hoffnung
marcar::markieren
Conmovedor::Bewegend
pienses::Denken
quiso::Er wollte
camisa::Hemd
neta::netto
suba::Komm hoch.
damos::Wir geben
guacaree::Guacaree
guacarear::Guacar
riendo::Lachen
falda::Bruststück
chingados::- Ja, ja.
Pensé::Ich dachte
estabas::Du warst
sorpresa::Erstaunen
Ahorita::Jetzt sofort
carajos::Die Hölle
comprometidos::begangen
Quería::Ich wollte
Seamos::Lasst uns sein
honestos::ehrlich
calla::Halt die Klappe.
aliento::Atem
pesada::schwer
escoge::Wählen
enamora::Sie verliebt sich
pases::Pässe
información::Information
necesitas::Du brauchst
Llama::Flamme
ahorrarán::wird speichern
citas::Datierung
recomendé::Ich empfahl
llevé::ich nahm
maestra::Lehrer
escuela::Schule
conocida::Bekanntschaft
estuviste::Du warst
sexual::fleischlich
avientes::Avientes
cenote::Cenote
peda::- Nein, nein.
consigamos::Lass es uns holen.
moleste::ärgern
casó::Verheiratet
millonario::Millionär
renta::Miete
siglos::Jahrhunderte
bajé::ich ging runter
apps::-Apps
toman::Nehmen
fallidas::fehlgeschlagen
contestar::Antwort
imagino::Ich stelle mir vor
Vivimos::Wir leben
tecnología::Technologie
clic::klicken
deshacer::aufmachen
consigan::Holen Sie sich es
chistoso::lustig
miserable::miserabel
mientras::als
todas::alle
casan::Sie heiraten
Miserable::Miserabel
mensaje::Nachricht
desesperadas::verzweifelt
desesperada::verzweifelt
mames::Mames
malas::schlecht
hubieras::Du hättest
peso::Gewicht
Llevas::Du trägst
fallando::scheitert
sorprende::Überraschung
coches::Autos
ambiente::Umgebung
pausa::pausieren
Cuando::Als
consigas::Du bekommst es.
celular::zellulär
batería::Batterie
orden::Bestellung
outfit::Outfit
diseñador::Designer
social::sozial
atún::Thunfisch
escritorio::Schreibtisch
Usen::Verwenden
femenina::weiblich
casual::leger
Procuren::Suchen Sie nach ihm
holgados::Baggy
ajustados::Eng
resaltar::Highlight
defectos::Defekte
Busquen::Suchen Sie nach ihm
colores::Farben
simples::einfach
estampados::Drucke
parada::Parade
Demasiado::Übermäßig
Sal::Raus
suplico::ich flehe an
reto::Herausforderung
fijan::reparieren
físico::physisch
mejorar::verbessern
aspecto::Aspekt
apariencia::Aussehen
física::physisch
acercado::näherte sich
reglas::Regeln
Apliquen::Anwenden
pantuflas::Pantoffeln
maravilla::Es ist wunderbar
pesos::Gewichte
inversión::Investition
tendrás::Sie werden haben
Igual::Gleich
escoja::wählen
acostumbrada::daran gewöhnt
apartado::distanziert
encuentro::Treffen
bóxers::Boxer
güeyes::Güeyes
femeninas::weiblich
esposa::Ehefrau
parezca::Sieht so aus
teibolera::Teibolera
lógica::Logik
Mucho::Viel
rapidito::Schnell, schnell
make::Machen
oyendo::Zuhören
cortaron::Sie schneiden
llegando::kommen in
urgidas::dringend
pusiera::setzen
perros::Hunde
cuñadita::Sündengesetz
juzgar::Richter
Adónde::Wo
depende::Hängt davon ab
espiando::Spionage
espío::Ich spioniere
bloqueó::gesperrt
Insta::Er drängt
Romper::Brechen
rutina::mahlen
acabaron::Sie sind fertig.
cenas::Abendessen
chaperón::Anstandsdame
línea::Linie
privado::privat
privacidad::Privatsphäre
consigue::Holen Sie sich es
sacerdote::Priester
pilates::Pilates
tomen::Nehmen Sie es
vayan::Gehen Sie weiter
Inscriban::Registrieren Sie sich
gimnasio::Turnhalle
Salgan::Raus
Afuera::Außerhalb
llevado::weggetragen
redes::-Netzwerke
utilicen::verwenden
recursos::-Ressourcen
posibles::möglich
maximizar::maximieren
cita::Termin
ñoña::Gnawl
Normalmente::Normalerweise
sutil::subtil
enciende::Schalten Sie ein
Donde::Wo
objeto::Objekt
iniciar::beginnen
conversación::Gespräch
fijen::Beheben Sie es
libro::buchen
página::Seite
Listo::Clever
Pase::Flüchtig
intentando::versuchen
sonreír::Lächeln
guardia::bewachen
traes::Du bringst
mamón::Schwanzlutscher
jugaron::Sie spielten
deben::müssen
manera::Manier
fan::Fan
ejercicio::Übung
duró::dauerte
chiquita::Kleines Mädchen
gustaba::Ich mochte es.
ballet::Ballett
perra::Hündin
corrieron::Sie liefen
barra::Bar
biografía::Biografie
hueva::Hueva
Limiten::Beschränken Sie es
pregunten::Fragen
abran::Öffnen Sie
conozcan::wissen
conexión::Verbindung
contando::Zählen
confió::Ich vertraute
truco::Kniff
trampas::Fallen
caigan::Fallen nach unten
enterando::herausfinden
principio::Anfang
oro::golden
Muestren::Zeig mir
convenga::es angebracht ist
harán::wird tun
fenomenal::phänomenal
Responde::Antworte mir
interesado::interessiert
teniendo::Peilung
existe::existiert
vibrador::vibrierend
excepciones::Ausnahmen
gay::homosexuell
Escuché::Ich habe gehört.
divorció::geschieden
banquero::Bankier
lana::Fleece
Seguirá::Es wird weitergehen
soltero::Bachelor
métodos::-Methoden
funcionen::Arbeit
macabreamos::makaber
repente::plötzlich
desaparece::Es verschwindet
desayunito::ich hatte gefrühstückt
posible::möglich
divorciamos::Wir haben uns geschieden
mordemos::Wir beißen
romántico::Romantisch
sensible::bemerkenswert
exposición::Belichtung
narcisista::Narzisst
parezco::Ich sehe so aus
puntitos::kleine Punkte
yuxtaposición::Gegenüberstellung
formas::Formulare
evoca::evoziert
antoje::Begierde
rosquilla::Donut
simpática::Schön
boxeo::Boxen
ex::Ex
platicamos::Wir haben geredet
conozcamos::Lasst uns kennenlernen
imaginar::vorstellen
Cortamos::Wir schneiden
enteré::Ich habe herausgefunden
comprometido::verlobt
estuche::Federmäppchen
monerías::Gelder
detalles::Details
llevó::LED
partido::übereinstimmen
solos::allein
pidió::gefragt
sentara::Setz dich hin
trajeron::Sie brachten
espectacular::spektakulär
güey::Kerl
Abogado::Anwalt
galanazo::Galanazo
dizque::Er sagte:
parecerá::es wird scheinen
acabó::Es ist vorbei
reven::reven
prestas::Kredite
cerrando::Schließen
ojitos::Kleine Augen
murmuras::Du murmelst
murmuro::Gemurmel
fotógrafo::Fotograf
exagera::übertreibt
Buenas::- Guten Morgen
huevo::Eierschale
idéntica::identisch
favoritas::Favoriten
saltar::springen
Vivo::Lebendig
prefiero::Ich bevorzuge
Gritas::Du schreierst
compartir::kommunizieren
porciones::-Portionen
chiquititas::Die Kleinen
ceviche::Ceviche
pulpo::Oktopus
tentáculos::Tentakeln
anchoas::Sardellen
quiera::Ich möchte
Cuenta::Konto
terminaste::Du bist fertig.
casado::verheiratet
Cenamos::Wir hatten Abendessen
permite::erlauben
identificación::Identifizierung
políticas::Richtlinien
dejé::ich kündigte
menor::moll
retórica::Rhetorik
vender::Deal
chelas::Chelas
anfetaminas::Amphetamine
unas::ein paar
problemas::Probleme
Encontró::Er hat es gefunden.
buscaba::ich habe gesucht
Noventa::Neunzig
caballero::Herr
recibo::Quittung
Quede::Bleiben
adiós::tschüss
igualito::Genau so
boletos::Eintrittskarten
Entramos::Wir sind in
Trajiste::Du hast mitgebracht
quedaras::Du bleibst
descubrir::entdecken
segunda::zweite
acá::hier
expresa::ausdrücken
sana::gesund
curiosidad::Neugier
fotografías::Fotografien
temas::Themen
serios::ernst
quedaste::Sie blieben
dormida::schlafen
duermo::ich schlafe
cine::Kino
masago::- Masago
gelatinosas::gelatineartig
recomiendo::Ich empfehle
omakase::Omakase
platillo::Becken
pesca::Fischfang
dedicas::Sie widmen
contenidos::Inhalt
digitales::digital
Manejamos::Wir fahren
Desarrollamos::Wir entwickeln
temporal::vorübergehend
volada::in die Luft gesprengt
Arquitecto::Architekt
ankimo::- Ankimo
foie::Foie
gras::Gras
hígado::Leber
pescado::Fisch
encantar::verzaubern
Buenísimo::Das ist großartig.
probé::Ich habe versucht
Fuertes::Stark
declaraciones::-Anweisungen
vecina::Nachbar
chismosa::Klatsch
caga::Er kackt
entreteniendo::Unterhaltsam
acordar::Akkord
junta::Brett
dimos::Wir gaben
sorprendido::Überrascht
posponer::Vertagung
negocios::Geschäft
tosco::grob
hablado::gesprochen
gatos::Katzen
segura::Ich bin sicher
perfectos::perfekt
moldear::Schimmel
moldeas::Du formst
horror::Horror
cerdos::Schweine
buscará::wird schauen
llamadita::kleiner Anruf
perfil::Flügelfolie
veías::Siehst du
retocar::retuschieren
Quieres::Sie möchten
micheladas::Micheladas
michelada::Michelada
pulquito::Titty
invito::Ich lade Sie ein
Vi::Ich sah
grabar::gravieren
disco::Festplatte
odies::Ich hasse dich
muchísimo::viel
estado::Nation
agarro::Schnappen Sie sich es
complicada::kompliziert
huequito::Kleiner Junge
sábado::Samstag
avisas::Du warnst
quesos::Käse
artesanales::handwerklich
buenísimos::Sehr gut
emocionas::Du bist aufgeregt.
insoportable::unmöglich
preparan::vorbereiten
pad::Polster
Camarones::Garnele
probado::getestet
propongo::Ich schlage vor
postre::Dessert
Queriendo::- Wanken
mango::Mango
fibroso::faserig
fresa::Erdbeere
mermelada::Marmelade
obviamente::offensichtlich
helado::Eis
chocolate::Schokolade
plática::Reden
seria::ernst
Siguen::Sie sind immer noch auf
borré::Ich habe gelöscht
divorciaron::geschieden
chiquitos::Die Kleinen
mudó::Er zog um
heredé::Ich habe geerbt
genes::Gene
escondes::Du versteckst dich
sintiendo::Gefühl
Buen::Oh, gut.
atrapar::fangen
saludes::Sag hallo
encantas::Du liebst es.
prestar::leihen
sacó::herausgezogen
cajita::kleine Kiste
sonriendo::lächelnd
sonrío::Ich lächle
brinca::Springen
refieres::Du meinst
compromiso::Engagement
distingue::unterscheidet
inteligente::intelligent
principiante::Anfänger
brillaba::glänzte
desesperen::Verzweifelt
conseguirán::wird bekommen
evento::Ereignis
externo::extern
permita::Erlauben Sie mir
paradas::stoppt
exactamente::genau
ofrecieron::angeboten
extranjero::fremd
contrato::Vertrag
departamento::Abteilung
vencer::schlagen
plantado::gepflanzt
metidita::Methydit
pata::Pfote
flojera::faul
preferible::bevorzugt
angustia::Todesangst
Loquita::Du verrückt
favorito::Favorit
salgamos::Lass uns raus.
bañar::baden
maleta::Fall
fresco::frisch
notas::Notizen
cítricas::Zitrusfrüchte
Rico::Köstlich
reposar::zur Ruhe
cítrico::zitronisch
manzana::Apfel
volviste::Du bist wieder da.
clavado::tauchen
Obviamente::Offensichtlich
impresionar::beeindrucken
supuestamente::angeblich
encantaba::Ich liebte es
tomé::ich nahm
Resultó::Es hat geklappt
cortaste::Du schneidest
Digamos::Sagen wir mal.
mutuo::gegenseitig
viajar::Reise
búsqueda::Suche
espiritual::geistig
embarazó::schwanger geworden
queríamos::Wir wollten
andar::Spaziergang
funcionado::funktionierte
tantito::Tantilittle
agarre::halten
tráfico::Datenverkehr
ruedo::Manschette
Juntar::Versammeln
imaginas::Du stellst dir vor
saliendo::Kommen Sie raus
esquina::Ecke
peta::peta
dejaba::Ich bin gegangen
pidiera::zu fragen
Pasa::Kommen Sie rein
seguí::ich ging weiter
consejos::Tipps
lograrías::du würdest es schaffen
distingues::Sie können sagen,
estudiante::Abbrecherin
modelo::Modell
juzgues::Richter
movimiento::Bewegung
arriesgado::chancy
pintora::Maler
pinto::ich male
desperdiciado::vertan
llevan::tragen
planean::Sie planen
próximo::neben
preparativos::Anordnung
precipitado::ausgefällt
aseguro::Ich versichere Ihnen
acompañas::Du gehst mit mir
existen::existieren
Hace::Vor
chillando::Quietschen
metida::im
Necesitas::Sie müssen
toques::Berührungen
A::BEI
subieron::Sie gingen nach oben
copas::Brille
cuates::Quates
bar::Bar
eran::waren
prepa::High School
discuten::sie/Sie argumentieren
adulto::Erwachsene
estallar::explodieren
Igualmente::Gleichermaßen
Bienvenido::Willkommen zurück
bicho::Bug
picó::Es hat gestochen
divorciados::geschieden
estresar::Stress
loquita::Schlammig
alterada::verändert
traguito::Schlucken
tequila::Tequila
arruinando::Ruinieren
divorciar::Scheidung
Queríamos::Wir wollten
prolongar::verlängern
Ayer::Gestern
abrí::ich öffnete
egoístas::egoistisch
arruinen::Ruinieren
amante::Liebhaber
encaje::Spitze
opinan::sie/Sie denken
escoger::wählen
chupe::saugen
otras::andere
escotado::geschnitten
voltear::umdrehen
stalker::Stalker
chingar::ficken
bajó::Er ging runter
halitosis::Mundgeruch
hablen::Reden
parado::aufstehen
menta::Minze
superbonita::Super hübsch
sirves::Du bist gut.
regué::Ich habe bewässert
comporté::Ich habe mich benommen
Creía::Ich dachte
olvidado::vergessen
extraño::ungerade
lastimar::verletzt
vainilla::Vanille
comprometida::verlobt
cambias::Du änderst
planeando::Planung
largo::lange
cometiendo::begehen
normal::normal
luna::Mond
continuar::weiterhin
lograr::erreichen
disfruta::Genießen
Buenísima::Das ist großartig.
Deliciosa::Oh, lecker
regalar::Geschenk
Pasó::Es geschah
platicar::Chat
casemos::Lass uns heiraten.
corres::Du läufst
corras::Laufen
Abre::Öffnen Sie
Entiendo::Ich verstehe es.
Perdiste::Du hast verloren.
hubo::gab es
inventé::Ich habe erfunden
volvieron::Sie kamen zurück
respira::Atmen
arruiné::Ich habe ruiniert
revistas::Zeitschriften
Llevamos::Wir tragen
consiguió::Ich habe es.
venta::Herberge
eventualmente::schließlich
moco::Schleim
mutante::Mutant
oso::Bär
cochina::- Oh, du böse.
colgando::hängend
permití::Ich erlaubte
comedias::Komödien
románticas::romantisch
conciertos::Konzerte
estando::Wesen
acompañado::begleitet
ocupado::beschäftigt
opuestos::Gegensätze
atraen::anziehen
embargo::Embargo
primeros::zuerst
declaro::Ich erkläre
quitó::nahm ab
depre::depre
sabido::bekannt
perdone::Entschuldigen Sie mich.
muera::sterben
machista::Sexist
aborté::Ich habe abgebrochen
misión::Mission
sirvió::serviert
prometido::Verlobter
Acaba::Beenden Sie es
matrimonios::Ehen
simpático::nett
gordito::mollig
entrando::Kommen in
quesadillas::Quesadillas
morfando::Morphing
exmarido::Ex-Mann
provecho::Vorteil
apartaste::Du legst beiseite
viniste::Du bist gekommen.
Foto::Foto
Vengan::Komm schon, komm schon.
supertristes::super traurig
apretando::Quetschen
Sonrían::Lächeln
dedo::Finger
bledo::Oh, nein.
distinta::anders
dueño::Eigentümer
critican::kritisieren
consta::es ist
Bailamos::Wir haben getanzt
Decido::Ich entscheide
cambiaré::Ich werde mich ändern
norma::Norm
mantendré::Ich werde behalten.
firme::Firma
convicciones::Überzeugungen
Reportaré::Ich werde berichten.
posiciones::Positionen
vestir::Kleid
integrantes::-Mitglieder
grupos::-Gruppen
armados::bewaffnet
desmovilizado::demobilisiert
contribuyen::beitragen
desaparecidos::fehlend
clave::Schlüssel
nacional::national
celebrado::gefeiert
funeral::Beerdigung
reconocida::anerkannt
fotógrafa::Fotograf
presuntamente::anscheinend
asesinada::ermordet
recientemente::kürzlich
galardonado::Laureat
prestigiosos::prestigeträchtig
Premios::Auszeichnungen
Europeos::Europäer
Innovación::Innovation
Emprendedor::Unternehmer
Año::Jahr
asaltar::Anschlag
asiático::asiatisch
declara::deklariert
inocente::unschuldig
afirma::behauptet
víctima::Unfallopfer
complot::Handlung
esperaba::ich hatte gehofft
Sra.::Frau
surgido::entstanden
contratiempo::contretemps
intentado::versucht
desconectado::getrennt
aseguró::versichert
pista::Hinweis
cambiaría::würde sich ändern
hablé::ich habe gesprochen
ignora::Ignorieren
citen::Aufhören
declarar::deklarieren
asegura::versichert
fiscalía::Staatsanwaltschaft
testigo::Taktstock
giro::Gyre
definitivo::endgültig
sabemos::wir wissen
trasladando::bewegend
dependencias::Abhängigkeiten
judiciales::Justiz
preste::leihen
declaración::Erklärung
lagunas::Lücken
verosimilitud::Wahrscheinlichkeit
basa::Basis
juez::Richter
colabore::zusammenarbeiten
policía::Polizei
celda::Zelle
vigilado::bewacht
tuviera::hatte
solicitar::Anruf
ingreso::Einkommen
inmediato::unmittelbar
prisión::Gefängnis
aconsejo::Ich berate
lamentar::Klagegesang
pongamos::Lass es uns sagen.
empecemos::Lassen Sie uns loslegen
hacían::tat
difunta::Verstorbene
hotel::Hotel
citaron::Zitat
llevábamos::Wir haben gewandet
descubrió::entdeckt
chantaje::Erpressung
instrucciones::Anweisungen
afrontar::zurechtkommen
quise::Ich wollte
vidas::lebt
sorprendió::überrascht
citaran::Zitat
inculpado::angeklagt
asesinato::Mord
Hablemos::Lass uns reden.
recibió::erhalten
móvil::mobil
Llevábamos::Wir haben gefahren
trampa::Betrügen
inconsciente::vergesslich
desperté::Ich wachte auf
empezó::Es fing an
recuerda::Denken Sie daran
golpes::Batterie
Aparte::Getrennt
alguien::jemand
suelo::Etage
resista::Halten Sie an
informe::Bericht
testigos::Zeugen
oyeron::Du hast gehört.
gritos::Schreien
vieron::Sie sahen
bloqueada::Abgesperrt
pudo::Er könnte
manecillas::Hände
forzadas::gezwungen
Especularon::Sie spekulierten
imposibles::unmöglich
huella::Fußabdruck
encontraron::Sie fanden
versión::Version
asesino::Mörder
evaporó::verdampft
escena::Szene
crimen::Kapitalverbrechen
inculpar::Frame
armara::Armara
falsa::Fälschung
teoría::Vermutung
enamoró::verliebte sich
proteger::Kissen
intenté::Ich habe versucht
absurdo::absurd
presta::leihen
Afirman::Sie behaupten
entorno::Umgebung
motivos::Gründe
modo::Manier
invención::Erfindung
culpable::schuldig
corresponde::entspricht
culpables::schuldig
estuviera::war
contara::wird zählen
pensaría::Ich würde denken,
tratado::Konvention
tipos::-Typen
clientes::Kunden
asumen::annehmen
colaboran::zusammenarbeiten
implique::implizieren
desean::wünschen
listos::Bereit
pretenden::vorgeben
salve::Hagel
condena::Verdammung
ensuciar::schmutzig
pertenece::Es gehört
aclare::klären
salvación::Befreiung
sufrimiento::Kummer
saque::Nehmen Sie es heraus
evite::vermeiden
cárcel::Gefängnis
mienta::Lüge
franceses::Französisch
antipáticos::unfreundlich
reunión::Treffen
cerremos::Lass uns schließen.
invita::lädt ein
iríamos::Wir würden gehen.
Vienes::Du kommst.
vosotras::Ihr Jungs
embarques::Lieferungen
dormidos::schlafen
Íbamos::Wir haben mitgemacht
Conduzco::Ich fahre
Conduce::Laufwerk
mintiendo::lügen
dijimos::wir sagten
llegara::wird ankommen
sacrificar::zerstören
nuestra::unsere
puto::Ficken
ciervo::Hirsch
invadido::eingedrungen
cinturón::Gürtel
reaccionado::reagierte
perdidos::verloren
arranca::Gehen Sie weiter
Arranca::Gehen Sie weiter
accidente::Unfall
desviado::abgewichen
cruzado::Kreuzritter
arreglado::Fixiert
mentido::Ich habe gelogen
quede::bleiben
ocupes::besetzen
podía::Ich könnte
dormido::schlafen
desvío::Umweg
jamás::nie
Jamás::Nie
sepulté::Ich habe begraben
resonaban::in Resonanz
manchas::Flecken
Llamé::Ich rief an
tarjeta::Karte
prepago::vorausbezahlt
avería::Aufschlüsselung
grúa::Kran
matado::Nerd
asistencia::Hilfe
saturados::gesättigt
dedillo::Fingerhut
máquinas::Maschinen
Menuda::Das ist ein großer.
Trabajé::ich arbeitete
ingeniero::Ingenieur
sede::Hauptquartier
taller::Garage
linterna::Taschenlampe
prestado::Ausgeliehen
preocupe::Sorge
cojo::lahm
sistema::System
arranque::Urlader
Probablemente::Wahrscheinlich
sensor::Sensor
bloqueado::gesperrt
centralita::Klappenschrank
remolcar::Schlepptau
arreglo::Anordnung
prefiere::bevorzugt
tardaría::Es würde eine Weile dauern
parque::Park
natural::natürlich
valle::Tal
profesora::Lehrer
Literatura::Literatur
dedica::Widmt
leer::lesen
teatro::Theater
debilidad::Schwäche
clásicos::Klassiker
apunté::ich zeigte
ligar::flirten
sonando::Klingeln
sesión::Sitzung
embarcas::ihr an Bord
iba::ich habe mitgefahren
retrasar::Verzögerung
informes::Berichte
operaciones::Operationen
interrupciones::Unterbrechungen
retrasas::Du verzögerst dich
despegáis::Du nimmst ab
vengas::Komm schon.
ceno::Ich habe zu Abend essen
avanzando::vorwärts bewegen
chocado::gestürmt
daño::Schaden
heridas::Wunden
infectar::infizieren
herida::Verletzung
muchísima::Viele von ihnen
hable::Sprechen Sie nach oben
limpias::sauber
sustos::Schrecken
cambia::Es ändert sich
pitando::Piepsen
reseteado::zurücksetzen
convencido::überzeugt
abrigo::Mantel
Pensaban::Sie dachten
Tendría::Ich würde
pongas::Setzen Sie es auf
planes::Anordnung
mayorcito::großer Junge
Oyes::Du hörst mich
imagina::Vorstellen
caído::Gefallen
ocurrido::aufgetreten ist
asustó::Ängstlich
desaparecer::verschwinden
constara::es wird aufgezeichnet
registro::Holzscheit
desguace::Verschrottung
Después::Nach
despedí::Ich habe gefeuert
acordando::zustimmen
veríamos::wir würden sehen
denuncié::Ich habe angeprangert
fingiendo::Täuschen
conté::ich zählte
sentía::ich fühlte
fraude::Betrug
impostor::Hochstapler
tardado::spät
fracción::Bruchteil
minúscula::winzig
Estábamos::Wir waren
entrada::Eintrag
ausentara::wird abwesend sein
Llevaba::Er trug
suceder::passieren
estropear::verderben
ordenar::Bestellung
pensamientos::Gedanken
máscara::Maske
vieran::sehen
inevitable::unvermeidlich
sucursal::Zweig
bancaria::Bank
aproximadamente::ungefähr
Posteriormente::Später
dirigió::LED
domicilio::Domizil
esperaban::warteten
Familiares::Familie
unido::vereint
Creen::Sie glauben
encuentre::finden
oculto::versteckt
barranco::Gully
grabada::aufgezeichnet
retina::Netzhaut
proyecté::Ich habe projiziert
dolor::Schmerz
cometería::Ich würde es tun
novedades::Nachrichten
juzgado::Gericht
trascendido::transzendiert
identidad::Identität
desembarcando::Aussteigen
adelantado::im Voraus
vuelves::Du kommst zurück.
detrás::hinter
controlado::gesteuert
Sigamos::Lasst uns weitermachen
centré::Ich konzentrierte mich
visita::Anruf
expediente::zweckdienlich
restos::Trümmer
colisiones::Kollisionen
desaparecido::verschwunden
siniestros::sinister
curioso::neugierig
recogió::abgeholt
desapareció::Er ist weg.
importará::wird von Bedeutung sein
sucedió::Es geschah
colisionó::kollidierte
carretera::Hauptstraße
obligan::Kraft
hipótesis::Hypothese
ocultara::verstecken
acompañante::Begleiter
matrícula::Kennzeichen
conducía::ich habe gefahren
aparcamiento::Parkplatz
Insinúa::Er unterschreit
ocultar::verstecken
pruebas::Beweismittel
denuncia::Beschwerde
aportar::beitragen
probaría::Ich würde es versuchen
guardar::halten
chaqueta::Jacke
extravió::verlegt
comisaría::Polizeiwache
conveniente::erwünscht
indicio::Hinweis
corroborar::untermauern
molestar::stören
Bastaba::Es war genug
nervioso::nervös
desaparición::Verschwinden
Estuve::Ich war
Comprar::Kaufen
coartada::Alibi
alternativa::Alternative
coincidencia::Koinzidenz
estropee::Ich hab's vermasselt
llames::Anruf
persiga::jagen
encargo::Brauch
Días::Tage
comprobó::überprüft
olvidaron::Sie vergaßen
trato::Schnäppchen
rescatar::Rettung
archivos::Dateien
policiales::Polizei
contactado::Kontaktiert
identificar::identifizieren
contactó::kontaktiert
rica::reich
protege::schützt
cámaras::Kameras
fugado::Er ist entkommen.
cabina::Kabine
puerto::Hafen
hábil::geschickt
traicionaron::betrogen
intentara::Ich werde es versuchen.
capaz::fähig
detenía::Ich habe aufgehört
abuelo::Großvater
cobras::Kobras
descartado::verworfen
sufriera::zu leiden
últimas::zuletzt
investigaciones::Ermittlungen
podría::Ich könnte
fingido::angenommen
fugar::Flucht
Fuentes::Quellen
informado::informiert
apoderó::beschlagnahmt
desvió::Er umgelenkt
pequeñas::Kleinen
cantidades::Mengen
zarpar::segeln
cogí::Ich hab's.
cargar::Last
maletero::Kofferraum
Aproveché::ich nutzte
experta::versiert
sistemas::Systeme
informáticos::Computersysteme
bancarios::Bankwesen
jurado::Jury
pensará::wird denken
imbéciles::Schwachkopf
empleada::Angestellter
banco::Bank
informática::Computing
avanza::Vorwärts bewegen
agigantados::Sprünge und Grenzen
reciclaba::recycelt
dedicaba::ich habe gewidmeten
fotografía::Fotografie
ayudó::geholfen
mantener::aufrechterhalten
margen::Marge
conoció::erfüllt
poder::können
seducción::Verführung
prototipo::Mockup
femme::femme
fatale::Fatale
rastro::Spur
estaríamos::würden wir sein
llamaste::Du hast angerufen.
hacíamos::wir taten
correcto::korrigieren
caigo::ich stürze
caerás::Du wirst fallen
amenaces::drohend
demuestran::demonstrieren
siguientes::nach
precisamente::präzise
gigante::Riese
tecnológico::technologisch
potente::mächtig
concedieron::gewährt
premio::Preis
anual::jährlich
Entré::ich ging rein
huracán::Hurrikan
mediático::Medien
vendieron::verkauft
salidos::Heraus
triunfadores::Triumphe
fachada::Fassade
Podrido::Du faul
enseña::Fähnrich
periodista::Journalist
insiste::Er besteht darauf, dass
disculpáis::Entschuldigen Sie mich.
huido::Er lief weg.
querría::Ich würde
prensa::drücken
habló::Er sprach:
usó::gebraucht
recogiera::abholen
trajera::bringen
cruzó::gekreuzt
ajustó::angepasst
asiento::Stuhl
arrancar::Stiefel
mintió::Er hat gelogen.
Mintió::Er hat gelogen.
miente::Er lügt
ocultaba::ich habe mich versteckt
confiamos::wir vertrauen
volvimos::Wir sind wieder da.
acusaba::angeklagt
supimos::wir wussten
montaje::Bearbeitung
hundió::Es sank
entendió::Er hat es bekommen.
significaba::gemeint
luchar::Kampf
descubrí::Ich entdeckte
supondría::würde
admitir::zugeben
siguieron::ging weiter
lobo::Wolf
lobos::Wölfe
terrorífico::erschreckend
quiten::Abheben
desaparezca::verschwinden
importe::Betrag
existir::existieren
descubrirán::wird herausfinden
intruso::Eindringling
confunde::verwirrt
Tuvieron::Sie hatten
deshizo::rückgängig gemacht
descanse::Ruhen Sie sich ein wenig aus
Acompañe::Kommen Sie mit
supiera::Ich wusste es.
Dirección::Richtung
relacionó::verwandt
Teléfono::Telefon
complicaría::würde komplizieren
logrado::erreicht
Volvió::Er ist zurück.
justas::fair
ocupar::besetzen
fichas::Chips
tablero::Brett
muertes::Todesfälle
cadáveres::Leichen
consecuencia::Konsequenz
directa::direkt
cadáver::Leichnam
sospechoso::fischig
sospechan::vermuten
sugiere::schlägt vor
puzle::Puzzle
misterio::Geheimnis
mató::getötet
relacionado::relevant
nombrado::ernannt
conductor::Treiber
citó::Zitat
Pudo::Er könnte
Detalles::Details
advierto::Ich warne Sie
comprará::wird kaufen
retorcida::verdreht
verosímil::lebensecht
pequeños::Kleinen
encuentren::finden
id::Gehen
cremallera::Postleitzahl
Sed::Hunger
puntuales::pünktlich
Llamaré::Ich rufe an.
entrega::Lieferung
enviado::Gesandter
remitente::Absender
firma::Autogramm
fijado::fixiert
enorme::riesig
agujero::Loch
relato::Geschichte
explica::erklärt
pantano::Sumpf
oí::Ich habe gehört.
hundir::Waschbecken
logró::verwaltet
viera::sehen
sospechara::verdächtig
fingiera::hat vorgegeben
Intenta::Probieren Sie es aus
alejar::weg bewegen
refugia::Obdach
chantajista::Erpresser
piensa::Denken
contesta::Antworte mir
descabellada::Du weißt schon, verrückt.
incriminatorio::belastend
principal::hauptsächlich
objetivo::Ziel
justamente::gerecht
gilipolleces::Bullshitty
inconexas::unabhängig
derrumbarán::sie/Sie werden zusammenbrechen
coherente::kohärent
fi::fi
Resuelva::Lösen Sie es
interrogante::Vexierfrage
partir::abweichen
accede::einloggen
usando::unter Verwendung von
rodea::Umgebung
Os::Sie
reservado::distanziert
dejad::Lass uns gehen.
papelera::Mülleimer
coged::Nehmen Sie es
pediré::Ich werde fragen
rellene::ausfüllen
ficha::Chip
Sospecha::Verdacht
armar::Arm
defensa::Verteidigung
poderoso::mächtig
cometer::begehen
responsables::verantwortlich
obligar::zwingen
Efectivamente::Genau
jugada::spielen
creyó::geglaubt
socios::Partner
financieros::finanziell
señaló::wies darauf hin
cargando::Laden
Solamente::Nur
fianza::Kaution
millonaria::Millionär
armaron::Sie stellen zusammen
sospecho::Ich vermute
servicios::Dienstleistungen
convencían::überzeugte sie
convencerían::würde überzeugen,
juicio::Urteil
preparadora::Ersteller
anunció::angekündigt
jubilaba::im Ruhestand
aceptado::bestätigt
implicar::implizieren
equivale::gleich
confesar::gestehen
resolver::entscheiden
desvanecer::verblassen
familiarizado::bekannt
concepto::Konzept
pensamiento::Stiefmütterchen
lateral::seitlich
Consiste::Es besteht aus
perspectiva::Perspektive
analizan::analysieren
acontecimientos::Ereignisse
granero::Scheune
completamente::völlig
vacío::leer
viga::Strahl
soga::Seil
ahorcó::gehängt
mide::Maßnahmen
metros::Meter
penden::Sie hängen
centímetros::Zoll
pared::Wand
cercana::nebenan
trepar::klettern
paredes::Wände
subió::Er ging hoch.
bloque::Block
archivo::Datei
fotográfico::Foto
policial::Polizei
Fije::Beheben Sie es
analizar::analysieren
enigma::Rätsel
Trabaja::Er arbeitet
tendió::Zelte
enviara::senden
paquete::Paket
uniera::vereinen
piezas::Stücke
rompecabezas::Puzzle
dudar::Zweifel
encontraría::Ich würde finden
pieza::Schlafzimmer
sepultó::vergraben
pantanosos::sumpfig
lugareños::Einheimische
moneda::Währung
picara::Es ist ein Stachel
delató::Er hat verraten
entregó::geliefert
deseo::Wunsch
estancia::Lounge
constancia::Konstanz
subieran::kommen nach oben
comba::Springseil
ejecutar::ausführen
escenario::Bühne
ruta::Pfad
marcado::markiert
Dejó::Er ist gegangen.
incriminar::beschuldigen
devolvió::zurückgegeben
encontraran::wird finden
huellas::Drucke
arma::Arm
producido::produziert
ruidos::Geräusche
suite::Suite
Aparten::Wegziehen
forenses::Die Forensik
Oído::Ohr
llevaron::Sie nahmen
evaporar::verdampfen
pareciera::Sieht so aus
Confirmado::Bestätigt
obliga::verpflichtet
rapidez::Speed
certifica::bescheinigt
obedece::Gehorchen
Supongamos::Nehmen wir an
cabaña::Kabine
alquiló::gemietet
circunstanciales::Indizien
ejecutó::ausgeführt
fingir::vortäuschen
huida::Flug
desfalco::Unterschlagung
acuse::beschuldigen
injustamente::ungerecht
sepultado::vergraben
encubrimiento::Vertuschung
cargo::Ladung
conciencia::Gewissen
Ubicaremos::Wir werden lokalisieren
anónima::anonym
pasional::Leidenschaftlich
acercaremos::Wir kommen näher.
queme::Burnout
quemar::brennen
situará::wird platzieren
desactivar::deaktivieren
reunido::versammelten
esperado::erwartet
asegurar::gewährleisten
Creímos::Wir glaubten
encontrara::wird finden
autopsia::Autopsie
delataría::Ich würde verraten
ayudaría::Es würde helfen
ahorrar::Bank
salvaré::Ich werde sparen
Decidí::Ich habe entschieden.
instante::instant
aprenda::lernen
ataques::-Angriffe
hundido::hohl
desesperación::Verzweiflung
provocar::entlocken
querrá::werden
arrogante::arrogant
defender::verteidigen
defienda::Verteidigen
manche::Fleck
cabos::endet
sueltos::lose
utilizando::unter Verwendung von
Testando::Testen
adulterada::verfälscht
hechos::Fakten
muñeco::Puppe
cuadra::Block
rompió::Er hat sich getrennt.
promesa::Engagement
crean::schaffen
Allí::Da drüben
estaré::Ich werde da sein.
objetos::-Objekte
contactos::Kontakte
Veamos::Lass uns sehen.
revés::Rückhand
Encajarían::Sie würden passen in
llevara::wird nehmen
iniciativa::Gumption
arrastrada::gezogen
límite::begrenzen
padeció::gelitten
agudos::scharf
desalmado::herzlos
instigadora::Anstifter
reforzaría::würde verstärken
salvado::Kleie
ahogó::ertrunken
cargó::geladen
hundiendo::sinken
recuperar::erholen
Contar::Zählen
aislado::isoliert
desplazó::verschoben
llamó::Er rief an
localizado::befindet
chantajeaba::erpresst
compensar::Offset
vacías::Leer
articuló::artikuliert
Programó::Er programmierte
medida::Maßnahme
protección::Schutz
negaría::würde leugnen
retorno::Rückkehr
pretendía::Ich wollte
enterraste::Du hast begraben
entregar::liefern
maté::Ich habe getötet.
atrapado::eingehakt
escapar::Flucht
Pensó::Er dachte:
buscó::gesucht
elementos::-Elemente
apoyar::Antlitz
rocambolesca::Rocambolesca
juguemos::Lasst uns spielen
desenterrará::wird sich ausgraben
liberar::befreien
incluso::sogar
penúltimo::vorletzt
confiar::anvertrauen
vigilando::Zuschauen
ajusticiar::ausführen
enteraron::Sie haben es herausgefunden
entendieron::Sie haben es bekommen.
Seguramente::Ich bin sicher
estudiaron::studiert
dudaron::bezweifelt
confianza::Zusicherung
justicia::Gerechtigkeit
Observar::Beobachten
enemigo::Feind
observar::beobachten
convirtió::konvertiert
Localizó::Er hat aufgespürt
ingenió::er hat es sich ausgedacht
acercara::, um nahe zu kommen
presenciado::Zeugen
Entendí::Ich hab's.
seguimiento::Follow-up
vigilar::bewachen
demuestra::beweist
citado::zitiert
trucada::LKWs
reflejo::Reflexion
admita::Zugeben
apagado::weg
Puerta::Tür
Hable::Sprechen Sie nach oben
descanso::Hiatus
estrategia::Strategie
Esté::Sei da
despejar::klar
llamando::-Aufruf
Completamente::Völlig
Tenías::Du hattest
Supone::Es ist angeblich
habrá::es wird sein
Subtítulos::Untertitel
Señores::Herr
babor::Port
ocho::acht
voces::Stimmen
solucionar::reparieren
Derecho::Richtig. Recht
oficial::offiziell
Oficial::Offiziell
Queremos::Wir wollen
Enterado::Ich hab's.
conozca::wissen
inocencia::Unschuld
Dormíamos::Wir haben geschlafen
camarote::Kabine
Mantenga::Halten Sie auf
rumbo::Kurs
estribor::Steuerbord
conocemos::wir wissen
ruega::Beten
tranquilamente::ruhig
entró::Er kam rein
pasajeros::Passagiere
saliera::komm raus
mantengan::Halten Sie auf
dure::zuletzt
tormenta::Sturm
permanezcan::Bleiben
subí::ich ging hinauf
don::Geschenk
champán::Champagner
camarotes::Kabinen
acudan::Komm schon.
Eviten::Vermeiden
pasillos::Flure
tengan::Haben Sie es
chalecos::Westen
salvavidas::Rettungsschwimmer
encontrarán::wird finden
Rápido::Schnell
detenido::Häftling
controlada::gesteuert
conocías::du wusstest
documentación::Dokumentation
encerrados::eingesperrt
Esperamos::Wir warten
pagaron::Sie bezahlten
breve::kurz
miligramos::Milligramm
pagó::bezahlt
convenceré::Ich werde Sie überzeugen
sobrevivir::überleben
Ayude::Helfen Sie mir
bala::Kugel
silva::Silva
intentaba::ich habe versucht
prometo::Ich verspreche
Realmente::Eigentlich
microfilm::Mikrofilm
ruega::Beten
destruido::zerstört
pecadores::Sünder
escondido::versteckt
peligroso::gefährlich
rosario::Rosenkranz
Sucede::Es passiert
promenade::Promenade
discreto::diskret
acude::Komm schon.
guardada::gespeichert
Calzado::Schuhwerk
calzado::Schuhwerk
debajo::unterhalb
Esconde::Verstecken
sabíamos::wir wussten
intérprete::Dolmetscher
sucede::Es passiert
contrató::angeheuert
subiendo::Gehen nach oben
extraer::Extrakt
mareada::schwindlig
enfermera::Krankenschwester
guantes::Handschuhe
Viajó::Er reiste
tapones::Stopfen
mareas::Gezeiten
ocasiones::Anlässe
subimos::Wir gehen nach oben
gastes::verbringen
delirando::wahnhaft
barco::Boot
polizón::Stowaway
ardiendo::Flammen
gasa::Gaze
conocía::Ich wusste es.
Teniendo::- Nehmen
confesión::Geständnis
muchacho::Junge
armario::Schrank
junto::zusammen
arteria::Arterie
transfusión::Transfusion
donante::Schenker
universal::Universell
Aprovecha::Nutzen Sie die Vorteile
salgan::Raus
asustada::Ängstlich
prudente::absichtlich
camarote::Kabine
Confío::Ich vertraue dir
sufrir::schmerzen
percance::Missgeschick
acompaño::Ich gehe mit dir
Sabré::Ich werde es wissen.
tuvierais::ihr hattet
cuestión::Problem
imprudente::unklug
devolviendo::zurückgeben
fiebre::Fieber
Dentro::Innenseite
suministrar::möblieren
suero::Tropf
alérgica::Allergisch
entregado::dediziert
timón::Ruder
Manteniendo::Warten
salvo::außer
Madre::Mutter
barco::Boot
chaleco::Ruckelruckchen
nadar::Schwimmen
Mientes::Du lügst
capitán::Kapitän
enfermería::Stillen
Capitán::Kapitän
pistola::Pistole
irresponsabilidad::Verantwortungslosigkeit
detuvieran::stoppen
Queda::Es ist übrig.
Dé::Geben Sie es
ordenado::ordentlich
protocolo::protokollieren
izar::hissen
botes::Boote
vestíbulos::Lobbys
apura::Beeilen Sie sich
flotando::Schwimmend
cubierta::Deck
ajeno::fremd
Tira::Ziehen
milla::Meile
referencias::Referenzen
tiraron::Sie warfen
aparecido::Gespenst
superficie::Oberfläche
quité::ich habe abgehauen
corrientes::Ströme
pájaros::Vögel
suelen::gewöhnlich
señoritos::Meine Damen
millas::Meilen
tuvieras::ihr hattet
empeñó::verpfändet
fuisteis::Du bist gegangen.
fiar::Ich vertraue dir
confían::sie/Sie vertrauen
durmió::Er schlief
parecer::erscheinen
indicado::angegeben
opinar::meinen
tengáis::werdet haben
respetos::respektiert
tendríamos::wir würden haben
perdamos::Lass uns verlieren.
travesía::Kreuzung
cogeremos::Wir fangen
responsable::haftbar
absoluta::absolut
discreción::Ermessen
centrar::Fokus
ecuador::Äquator
pasaje::Passage
viaja::Er reist
celebren::feiern
vivos::lebendig
Viaja::Er reist
don::Geschenk
celos::Eifersucht
soporta::Unterstützt
sirviente::Knecht
quepa::es wird passen
Exacto::Exakt
cometemos::wir verpflichten
errores::Fehler
pidiendo::fragen
decidió::entschieden
aceptar::akzeptieren
caradura::frech
acostumbrado::gewöhnt
Presten::- Lass uns gehen.
Reconocen::Sie erkennen
Viajaba::ich war bereist
restringido::begrenzt
acceso::Zugang
cerradura::Schloss
arreglen::Beheben Sie es
destrozo::Zertrümmern
insignia::Abzeichen
turbulencias::Turbulenz
Diario::Täglich
bamboleo::eiern
bordo::Brett
guardé::Ich habe gerettet
mece::Fels
navegación::Navigation
tres::Drei
acuestas::Du legst dich hin
asesinadas::ermordet
acaso::vielleicht
Fenomenal::Das ist großartig.
conste::für den Datensatz
medidas::Messung
adecuadas::angemessen
saliste::Du bist ausgegangen.
preocupado::besorgt
tempestad::Sturm
comenzó::es begann
convencidos::überzeugt
Tanto::So viel
atrancada::festgefahren
equivocados::Falsch
acompañada::begleitet
Nerviosa::Nervös
Estabas::Du warst
disparado::Schuss
operar::betreiben
urgencia::Notfall
ida::Ein Weg
mueva::Bewegen
matar::töten
encuentran::finden
Perdió::Er verlor
presentó::präsentiert
Avisaré::Ich lasse es Sie wissen.
voluntaria::freiwillig
compatibles::Kompatibel
defendemos::wir verteidigen
sospechaba::Ich habe verdächtigt
guardias::Wachen
síntoma::Symptom
fatiga::Müdigkeit
leve::mild
ruego::ich flehe an
sarpullido::Hautausschlag
avise::Warnen
cubierta::Deck
desordenado::unordentlich
llore::Weinen
disparar::Feuer
locas::Verrückt
obsesión::Besessenheit
sos::Sie sind
permitido::erlaubt
desembarcan::Ausschiffen
perdonado::Verzeiht
Río::Fluss
equipaje::Gepäck
Encargado::Manager
pensó::Er dachte:
bajado::Unten
baúl::Brust
carga::Belastung
necesitás::Du brauchst es.
naviera::Reederei
prometida::Verlobte
señorita::Fräulein
Encantadas::Erfreut
pensarás::du wirst denken
ceder::zugestehen
sobrinas::Nichten
chantajea::Erpressung
acostumbramos::Wir gewöhnen uns daran
fusilar::um zu schießen
frambuesa::Himbeere
tarta::Kuchen
celebración::Feier
negocia::Verhandeln
instalar::installieren
gentuza::Pöbel
cantidad::Betrag
destruir::zerstören
detenidas::verhaftet
harto::gerädert
aviso::Werbung
salvar::Flucht
botones::Hotelpage
pellejo::Pelz
peligrosas::gefährlich
acompañará::wird Sie begleiten
Estarán::Sie werden
necesario::notwendig
Insistía::Er beharrte darauf
ilusionadas::illusioniert
golpe::Schlag
ensayar::Assay
desde::aus
formaba::gebildet
agradecerá::wird es Ihnen danken
ánimo::Stimmung
debió::Er muss
faltaré::Ich werde vermissen
supongo::Ich schätze
lámpara::Lampe
recepción::Rezeption
camiones::LKWs
proteja::schützen
tratas::Du versuchst es
afinidad::Affinität
enfadada::Zornig
Despeñaron::Sie wurden geräumt.
basilisco::Basilisk
copiloto::Copilot
disculpa::Entschuldigung
confiado::zuversichtlich
peligro::Gefahr
padrino::Patenonkel
pasaré::Ich werde vorbeigehen
maravillosa::Wunderbar
encargue::Bestellung
alojamiento::Unterkunft
embarcar::einschiffen
cruzando::Kreuzung
mantenga::Halten Sie auf
flote::schweben
dará::wird geben
ingeniería::Engineering
comienzo::Anfang
entusiasmado::aufgeregt
eslora::Länge
dirá::wird sagen
imaginen::Vorstellen
tumbada::Legen Sie sich hin
máxima::Maxime
ocultando::Verstecken
nudos::Knoten
caballos::Pferde
turbinas::Turbinen
turboeléctricas::Turbo-elektrisch
Intenté::Ich habe versucht
monstruo::Monster
barbaridad::Barbarei
impedir::behindern
Sábanas::Blätter
siguiera::weiter gehen
toallas::Handtücher
algodón::Baumwolle
egipcio::ägyptisch
enviando::senden
inocentes::unschuldig
firmados::signiert
falsos::Fälschung
manipuló::manipuliert
transporte::transportieren
campos::-Felder
concentración::Konzentration
enterrada::vergraben
aparecer::erscheinen
limpiará::wird bereinigen
confirmará::wird bestätigen
ordenará::bestellen,
teléf::Telefon
utilizar::anwenden
intentó::Er versuchte es.
asesinar::ermorden
informar::benachrichtigen
harían::würde
desembarcar::abladen
devuelvan::Geben Sie es zurück
Cuanto::Wie viel
sobrina::Nichte
metieses::Du kommst rein
interrogatorio::Verhör
maquinistas::Maschinisten
apoyo::Ermutigung
huye::Er läuft weg
Formamos::Wir bilden
confía::Vertrauen Sie mir
fiemos::Wir vertrauen
molestaré::Ich störe dich.
absoluto::absolut
despistado::ahnungslos
pasad::Kommen Sie rein
saludar::grüßen
traerán::Sie bringen
molestas::ärgerlich
Ocurre::Es passiert
trajes::Anzüge
superior::Top
relatos::Geschichten
Don::Geschenk
medianoche::Mitternacht
Verá::Sie werden sehen
acusado::angeklagt
sucedía::Es geschah
creído::arrogant
confirmado::bestätigt
Necesitáis::Du brauchst es.
disfrutemos::Lassen Sie es uns genießen
organizar::organisieren
Esperaremos::Wir warten
Salí::Ich bin rausgestiegen
valga::Es lohnt sich
responda::Antworte mir
actuación::Leistung
contraria::im Gegenteil
riesgo::Gefahr
encontraba::gründen
estómago::Magen
pillen::Holen Sie sich es
delicado::zart
absoluto::absolut
amigable::freundlich
trayendo::Bringen
expliqué::Ich habe erklärt
detective::Detektiv
baúles::Stämme
suban::Komm hoch.
despejados::Klar
vientos::Winde
racheados::böig
noreste::Nordosten
fuerza::Kraft
mínimas::Minimum
corriente::Strom
máximas::maximal
albatros::Albatros
Informar::Benachrichtigen
fario::Fario
mía::lieber
supersticiones::Aberglauben
encinten::Band
grieta::Riss
incordiar::unverzündlich
llegaría::Ich würde dort hinkommen.
sobrina::Nichte
retirar::lösen
tempestad::Sturm
lima::Kalk
tartas::Kuchen
soporto::Ich kann stehen
andrajoso::Raggedy
Empezando::Erste Schritte
andaba::ich war spazierengegangen
tartas::Kuchen
calles::Straßen
Avante::Vorwärts
descubrirá::wird herausfinden
alumbra::beleuchten
lentas::Langsam
farola::Laternenpfahl
bastó::Es war genug
Dicen::Sie sagen:
incendiar::zünden
Querías::Du wolltest das
Virgen::Jungfrau
manto::Erdmantel
mordiendo::Beißend
encerrar::verriegeln
ocurrir::passieren
apechuguen::Verschwinde hier.
catres::Kinderbetten
cero::nil
señores::Herr
digno::würdevoll
comprobando::Überprüfung
hunde::Es sinkt
Tomaremos::Wir nehmen es
prefieras::du bevorzugst
fallecer::sterben
vendido::Verkauft
enamores::in der Liebe
renunciado::zurückgetreten
Simplemente::Nur
muchacha::Mädchen
dama::Dame
sinceramente::Ehrlich
fuese::zu gehen
acordaría::Ich würde zustimmen
victoriosa::siegreich
griego::griechisch
Mujer::Mädchen
acontecimiento::Ereignis
movemos::Wir bewegen uns
adonde::wo
adoro::Ich liebe es
pensarás::du wirst denken
escribir::Stift
enfadarán::Sie werden wütend werden
querrán::sie/Sie werden
barcos::Boote
ingenieros::Ingenieure
recojo::ich abholen
Señor::Oh, Sir.
ofendan::Beleidigen
compruebo::Ich überprüfe
revivir::erleben Sie noch einmal
guerra::Krieg
imagináis::du stellst dir vor
recuperé::Ich habe mich erholt
chatarra::ändern
Creerán::Sie werden glauben
Disculpad::Oh, entschuldigen Sie mich.
Encantado::Erfreut
golpeé::ich schlug
Queridas::Liebste
presumir::prahlen
contáramos::lasst uns zählen
absolutamente::absolut
Doctor::Doktor
recuerdas::Erinnern Sie sich
jeringuilla::Spritze
merece::Er verdient
acepta::Er akzeptiert
subido::oben
dispuesto::verträglich
tranquilidad::Ruhe des Geistes
pagaría::Ich würde zahlen.
ocupa::besetzt
tratos::Angebote
confundido::verwirrt
brindar::Toast
referente::bezüglich
traidores::Verräter
Justamente::Gerecht
entenderíamos::würden wir verstehen
baila::Tanz
gritas::Du schreierst
Busquemos::Schauen wir uns an.
Mirar::Aussehen
Imbécil::Dummkopf
Creíamos::Wir glaubten
perseguía::ich habe gejagt
persiguiendo::- Jagen
encontraste::Sie haben es gefunden.
atacando::angreifen
buscabas::du hast gesucht
Lleven::Nehmen Sie es
Afortunadamente::Glücklicherweise
custodia::Monstranz
salvó::Er rettete
insensato::Du Narr
grita::schreien
robar::Einbrecher
entregara::zu liefern
documento::Dokument
atacó::angegriffen
ocultó::Verborgen
tijeras::Schere
denunciar::verurteilen
asesinó::ermordet
adoraba::Ich habe verehrt
disfraza::Verkleidung
arroja::wirft
lógico::logisch
Murió::Er ist gestorben.
causar::verursachen
quemaron::Sie verbrannten
querían::wollte
quisiesen::möchte
Llegó::Er ist hier.
ayudante::Assistent
ayudes::helfen
tapada::verstopft
venda::Verband
consulta::Konsultation
vendaje::Verband
infecte::infizieren
desea::Sie wollen
Buscaba::ich habe gesucht
nocturna::jeden Abend
cuaderno::Notebook
Desapareció::Er ist weg.
cuadran::Sie passen
entregada::geliefert
virado::gedreht
autoridades::Behörden
Murieron::Sie starben
incendio::Feuer
permanecerá::wird bleiben
descontrole::außer Kontrolle
meteorológico::meteorologisch
sepamos::lasst uns wissen
anuncia::verkündet
contiene::enthält
misterios::Mysterien
comprender::begreifen
pediros::fragen Sie
Fuera::Außerhalb
carajo::Schwanz
implicado::verwickelt
pierda::verlieren
aclarando::Klärung
diremos::wir werden sagen
aclarado::geklärt
detengan::Stoppen
exagerada::übertrieben
espere::Warte, warte.
encerrada::Eingesperrt
desayuno::Frühstück
Fuiste::Du bist gegangen.
Encontraron::Sie haben es gefunden.
desayunar::Frühstück
simple::fad
traductora::Übersetzer
descansado::ausgeruht
estupenda::Großartig
dudado::bezweifelt
recogerás::du wirst abholen
preferiría::Ich würde lieber
improvisar::improvisieren
Buscaba::ich habe gesucht
medallón::Medaillon
Simuló::Er tat so, als hätte er
zapato::Schuh
veré::Ich werde sehen.
seguramente::Ich bin sicher
recuperado::erholt
Organizar::Organisieren
ánimos::Stimmung
incidente::Vorfall
colgante::Anhänger
encargar::Provision
reparar::reparieren
indicada::angegeben
opinas::Du denkst
grave::Grab
pasas::Rosinen
azúcar::Zucker
agradece::vielen Dank
Creer::Glauben
regresando::Kommen zurück
virar::Ecke
espléndido::Prächtig
deducir::ableiten
continúen::Weiter geht's
vigila::Achte auf
guardó::gespeichert
atravesar::Kreuz
Parecen::Sie sehen so aus
experimentado::erfahren
guarden::Halten Sie es auf dem Laufenden
socio::Partner
albaranes::Lieferscheine
resistes::Du widerstehst dich
equivoco::Falsch
marcos::Rahmen
Resolvamos::Lass es uns herausfinden
imperiales::imperial
pedidos::Bestellungen
Retomemos::Kommen wir zurück zu ihm
salían::sie/Sie haben ausgezogen
recurriré::Ich werde zurückgreifen
mandaban::Sie waren verantwortlich
campo::Feld
monstruos::Monster
contundentes::stumpf
deseamos::Wir wünschen
esperará::wird warten
atreve::Wagen
condescendencia::Herablassung
autoridad::Behörde
sano::gesund
delatara::Er wird verpfiffen
descubierto::offenkundig
lamentablemente::leider
discutimos::Wir argumentierten
actitud::Haltung
violentamente::gewalttätig
denunciáis::du denunzieren
Llevando::Tragen
razonar::Grund
acabaré::Ich werde fertig sein.
fusilado::Schuss
bebiste::Du hast getrunken
cansado::Müde
salíamos::wir haben ausgezogen
razonamiento::Argumentation
fallecido::Verstorbene
provocado::provoziert
Observe::Beobachten
Paren::Stoppen Sie es
hematomas::Prellungen
obedecer::gehorchen
golpea::Hit
aclarar::klären
entenderá::Sie werden verstehen
gratificación::Befriedigung
código::Code
cuente::Zählen
Activemos::Lassen Sie uns aktivieren
subieses::Du gehst nach oben
Poco::Wenig
desayuno::Frühstück
necesarias::notwendig
oporto::Port
Imagino::Oh, schätze ich.
Imaginas::Vorstellen
mayordomo::Butler
Salga::Raus
enfadado::zornig
equis::X
Odio::Hass
telegrama::Kabel
desayunar::Frühstück
esperen::Warte, warte.
pensábamos::wir dachten
escondidas::versteckt
directos::direkt
fueras::gehen
sube::Steh auf
ladrona::Gauner
mayordomo::Butler
preferiría::Ich würde lieber
señorito::Meister
pasas::Rosinen
reta::Herausforderung
Estará::Er wird da sein.
pues::zum
metes::Du kommst rein
sirviendo::Portion
escribe::Schreiben
subes::Du gehst nach oben
Tenga::Hier gehst du
cogió::nahm es
irá::wird gehen
reconocí::Ich erkannte
entré::ich ging rein
bebiendo::trinken
Cogí::Ich hab's.
mareó::Er wurde schwindlig
olvides::Vergiss es
Estate::Bleiben Sie hier
llevaré::Ich nehme dich.
preocupando::besorgniserregend
arándanos::Heidelbeeren
desgracia::Unglück
autor::Autor
invirtió::investiert
francés::Französisch
jugué::ich spielte
juraste::Du hast geschworen
lujo::Luxus
defendí::Ich habe verteidigt
juega::Spielen
inconformista::Hipster
dispongo::Ich bin bereit
luchó::gekämpft
prejuicios::Vorurteil
lleguemos::Lass uns dorthin kommen
humos::Dämpfe
solucionaremos::Wir werden es aussortieren.
razonable::fair
contaba::ich zählte
extorsionando::Geld erpressen
gustes::Du magst es
comprometa::Kompromiss
amenazas::Drohungen
lamentable::beklagenswert
altivo::arrogant
comprometer::Kompromiss
egocéntrico::egozentrisch
déspota::Despot
iluso::getäuscht
regresamos::Wir sind wieder da.
investigar::untersuchen
explicar::erklären
acabarán::Sie werden vorbei sein.
daría::Ich würde geben
descubriendo::Entdeckungsreise
Algo::Jeder
sandeces::Quatsch
casé::Ich habe geheiratet
venía::ich habe mitgekommen
asistente::Assistent
tendrías::du hättest
Imagino::Oh, schätze ich.
trabaje::Arbeit
sincero::ehrlich
apareciste::Du bist aufgetaucht.
francesa::Französin
seguimos::Wir gehen weiter
invadieron::eingedrungen
resistencia::Ausdauer
botellas::Flaschen
Volaron::Sie flogen
convoy::Konvoi
andará::Er wird gehen.
represalia::Vergeltung
ausentado::abwesend
metieron::sie/Sie erhielten auf
probable::wahrscheinlich
gustas::wie Sie
molestes::ärgern
organicen::Organisieren
capilla::Kapelle
prestó::ausgeliehen
duele::Es tut weh
lástima::schade
propuso::vorgeschlagen
insensible::unempfindlich
acertado::geeignet
encerrada::Eingesperrt
voluntariamente::freiwillig
acusación::Anklageschrift
invierta::investieren
Convertir::Konvertieren
azúcar::Zucker
combustible::Brennstoff
encontremos::Lasst uns finden
puro::Zigarre
apuesto::stattlich
interés::Interesse
Haga::Tun Sie es
serlos::um sie zu sein
cruzaremos::Wir überqueren
recuperado::erholt
retraso::Verzögerung
sucedido::ist passiert
trasladó::bewegt
escuchado::gehört
pagan::bezahlen
Habla::Sprechen Sie nach oben
instalado::installiert
contiguos::zusammenhängend
escondió::Verborgen
señalado::wies darauf hin
sentimental::Gefühl
fío::vertrauen
Confía::Vertrauen Sie mir
alivio::Linderung
asusté::Ich habe Angst
malos::böse Jungs
recuerdos::Erinnerungen
ocuparé::Ich kümmere mich darum.
enganchado::eingehakt
torpeza::Unbeholfenheit
arreglaré::Ich werde es reparieren.
niego::Ich weigere mich
joyería::Schmuck
vestíbulo::Eintrag
meteré::Ich werde reinkommen.
colgante::Anhänger
Últimamente::In letzter Zeit
mientes::Du lügst
tontería::Unsinn
volviendo::kommen zurück
nerviosas::nervös
suelto::lose
interesada::interessiert
encargará::wird arrangieren
perdería::Ich würde verlieren
enganchó::eingehakt
Confiemos::Vertrauen wir ihm
adecuado::angemessen
Comprueben::Sieh es dir an
Recojan::Abholen
hamacas::Hängematten
preparados::Bereit
enfrentado::konfrontiert
tormentas::Stürme
adivino::Wahrsagerin
parpadeo::Flimmern
marcando::Wählen
alumbraron::Sie leuchteten
pálidos::blass
reflejos::Reflexe
Hondas::Einzel
truenos::Donner
bebe::Baby
calmaría::es würde sich beruhigen
borda::Dollbord
tendrías::du hättest
suya::seine
agarren::Schnappen Sie sich es
recen::Beten
empeorar::verschlimmern
arreciando::Reefing
termine::Ich bin fertig.
colocados::platziert
pasillo::Gang
guardaba::ich behielt
obligué::Ich habe es gezwungen.
encontraremos::Wir finden
suegro::Schwiegervater
fallecimiento::Verstorbenen
privó::beraubt
Comprometido::Verlobt
civilización::Zivilisation
valores::-Werte
lealtad::Loyalität
libertad::Freiheit
disponemos::wir haben
patente::Patent
ausencia::Abwesenheit
conducir::Laufwerk
comprende::Er versteht
sufro::ich leide
Canto::Anruf
sollozar::Schluchzen
Casar::Heiraten
precipitada::hastig
precede::vorangeht
incauta::Incaut
acercas::Du kommst näher
deriva::Spielraum
dondequiera::überall
hallar::finden
andarás::Du wirst gehen.
aventuras::Abenteuer
aburridos::langweilig
abres::Sie öffnen
escuchas::Du hörst zu
Echa::Werfen Sie es raus
sirva::dienen
superar::überwinden
Estrella::Stern
estirada::ausgestreckt
excepción::Ausnahme
demuestro::Ich beweise es
pipa::Bong
indispuesta::unpässlich
tomaremos::Wir nehmen
cable::Kabel
novedad::Neuheit
observando::beobachten
conociera::um zu wissen
sitios::-Seiten
desenvolver::auswickeln
molesto::ärgerlich
tesoro::horten
arrullo::Schlaflied
palma::Handfläche
bebido::betrunken
queja::Beschwerde
miras::Du siehst aus
ansia::Begierde
caney::- Caney
Vayamos::Lass uns gehen.
complicados::kompliziert
acostumbra::Es ist daran gewöhnt
vaivén::swiven
Vivir::Leben
Tranquilos::Nehmen Sie es einfach
intentas::Du versuchst es
borrando::Löschen
respiraré::Ich werde atmen.
bailado::getanzt
impresiona::beeindruckt
oscuridad::Dunkelheit
enamorando::sich verlieben
navegando::Segeln
marino::Marineinfanterist
relojes::Uhren
Relojes::Uhren
pillara::Ich werde fangen.
enorgullezco::Ich bin stolz.
avergüenzo::Verlegen
robé::Ich habe gestohlen
metía::ich war in
naval::Marine-
aproveché::ich nutzte
traslada::bewegen
editor::Editor
literario::literarisch
segundas::zweite
Puente::Brücke
Atención::Aufmerksamkeit
máquina::Maschine
grados::Grad
suave::sanftmütig
proyectan::Projekt
sombras::Schatten
grito::weinen
disposición::Anordnung
Regresemos::Gehen wir zurück.
colaboración::Zusammenarbeit
Pasemos::Lasst uns durchkommen
ordenadamente::ordentlich
interior::Interieur
Preparen::Stand by
subía::ich habe hochgefahren
temblando::zitternd
golpeado::verprügelt
marchado::Er ist weg.
Señorita::Fräulein
quitado::entfernt
explique::erklären
inconscientes::bewusstlos
Pasen::Kommen Sie rein
revuelto::Rührei
Comprobad::Sieh es dir an
inconcebible::unbegreiflich
accedía::Ich stimmte zu
Matar::Töten
dijerais::du sagst
avisado::Gewarnt
alejara::Es wird sich wegbewegen
pelea::Schlägerei
dais::Du gibst
tirado::Lunge
teorías::Theorien
absurdas::absurd
Absurdas::Absurd
recoged::Abholen
falte::fehlend
fijar::reparieren
sentadas::Setz dich hin
averiguar::feststellen
Hizo::Er tat es.
Trate::Versuchen
cayera::wird fallen
acuesta::Gehe ins Bett
confidencial::vertraulich
contenido::Inhalt
autorizado::autorisiert
todos::alle
modos::-Modi
calmante::Beruhigend
orientación::Orientierungsvermögen
direcciones::-Adressen
indicadas::angegeben
despiste::ich gab auf
tratar::Deal
preocupada::besorgt
retener::verhaften
surgir::entstehen
especulaciones::Spekulationen
comunicado::Kommuniqué
intereses::Interesse
alarmar::Alarm
amenazó::bedroht
investigando::Ermittlungen
tomes::Nehmen Sie es
embarcamos::Wir sind an Bord
responsabilidades::Verantwortlichkeiten
jugando::spielen
recital::Erwägungsgrund
actuara::wird handeln
personalidad::Persönlichkeit
cantante::Sängerin
interesar::Interesse
crucero::Kreuzfahrt
asustar::zu erschrecken
durmieras::schlafen
aun::sogar
calmantes::Schmerzmittel
Estuviste::Du warst
espiar::spähen
mintieras::Du hast gelogen
Sospechas::Verdächtig
acusé::Ich habe angeklagt
resultó::es stellte sich heraus
exagerado::übertrieben
desconfiar::Misstrauen
regaló::verschenkte
forzado::gezwungen
Echan::Sie treten raus
maletas::Koffer
estuvieron::Sie waren
acceder::Zugang
introdujeron::eingeführt
bodegas::Kellern
valiosas::wertvoll
tentación::Versuchung
registraron::aufgezeichnet
ratero::Gauner
echamos::Wir werfen raus
Seguridad::Sicherheit
revisen::Sieh es dir an
Tercera::Dritte
debido::fällig
hablaré::Ich werde reden.
arregle::Beheben Sie es
posibilidad::Chance
normalidad::Normalität
entendés::Du verstehst
Mirá::Aussehen
lograron::verwaltet
sabés::Du weißt, dass du
Entendés::Du verstehst
robó::Stola
tiró::warf
anillos::Ringe
alianzas::Allianzen
acusaste::Sie beschuldigt haben
sospecha::Verdacht
queráis::Sie möchten
equivocas::Falsch
disculpas::Entschuldigen Sie
aprecio::Ich weiß es zu schätzen
formal::formal
luchador::Kämpfer
temes::Du hast Angst.
fantasías::Phantasien
Ocupa::Besetzen
Sigan::Weiter geht's
echará::wirft heraus
bronca::Schlägerei
afortunada::Glücklich
crie::ich erhob
orfanato::Waisenhaus
cuento::Ich sag es dir
simplemente::nur
caña::Rohrstock
petróleo::Öl
propondré::werde ich vorschlagen
prosperar::gedeihen
horizonte::Horizont
ensanchar::weiten
mentes::Köpfe
gafas::bespectacled
segundín::zweite
acompañaras::wirst du begleiten
cenemos::Lasst uns essen.
cantina::Kantine
duerme::Schlafen
paja::Spreu
biblioteca::Bibliothek
Encontrará::Sie finden
agrado::Geschmack
recomendación::lobenswert
leído::lesen
gustará::wird es mögen
presenta::Geschenke
representante::Manager
artistas::Künstler
Novio::Freund
sentado::Setz dich hin
paseo::Spritztour
enfades::Wut
interesas::Sie sind interessiert
resultar::folgen
venas::Venen
Esperas::Warten Sie
Reconoce::Erkennen
pendientes::ohrringe
lujoso::luxuriös
Abriste::Sie haben es geöffnet.
llevaste::Du hast
sorprendí::Ich überraschte
tapé::ich vertuschte
gritara::schreien
revolvió::aufgerührt
codazo::Ellbogen
calmara::beruhigen Sie sich
aseguré::Ich habe dafür gesichtigt.
Muerta::Tot
dato::Daten
honestamente::ehrlich
vulgar::vulgär
confesado::Geständet
Pensaba::ich habe gedacht
Oíste::Du hast mich gehört.
gritado::schrie
sorpresas::Überraschungen
preparadas::Bereit
dispuesta::bereit
ayudarás::Du wirst helfen
Servicio::Annehmlichkeit
lavandería::Wäscherei
Recuerda::Denken Sie daran
chispa::Funke
abra::Öffnen Sie
dejemos::Lasst uns aufhören.
eche::Raus
básicamente::im Grunde
abro::Ich öffne
esperamos::Wir warten
fría::kalt
abriendo::Öffnung
Biblia::Die Bibel
usada::gebraucht
lee::Lesen
solas::allein
metemos::wir schwingen ein
desabrochado::aufgeknöpft
millón::Million
ángel::Engel
transformas::Transformationen
hipnotizada::hypnotisiert
estuvieran::waren
disfrutas::Sie genießen es
vuelas::Du fliegst
concretar::konkretisieren
parecería::es scheint
actuar::handeln
esperan::Warten
contestado::Antworten
equivocada::Falsch
pensarán::wird denken
pensabas::Du dachtest
robando::Diebstahl
gritó::schrie
escuchamos::Wir hören zu
mataste::Du hast getötet.
condenarán::wird verurteilen
librará::wird liefern
merecen::sie/Sie verdienen
enterarán::Sie werden es herausfinden.
sabrá::werden wissen
inculparas::angeklagt
matarían::würde töten
perfidia::perfidy
nica::Nica
ndo::NDO
raz::- Raz
S::S
m::m
ltame::Lahm
pegu::Pegu
ada::d
n::n
pap::Brei
monos::Affen
c::c
adita::Adita
regresaste::Du bist wieder da.
d::d
perdi::ich verlor
nde::nde
cort::Cort
rminos::rminus
cticos::ctic
japon::japanisch
imagin::Imagin
adentro::Innenseite
ah::aah
incre::Incre
ble::ble
ning::Ning
ondas::Wellen
enga::lahm
mamas::Mütter
cabr::Tasse
conquist::Eroberung
atrap::Falle
bamos::Bamos
amos::Meister
gre::Gre
udas::Oh, du weißt schon.
adir::hinzufügen
ech::Ech
acompa::Kommen Sie mit
Pr::Pr
stamelo::Stamelo
otro::andere
Perd::Perd
D::D
melo::Melo
conmovedor::bewegend
arruin::Ich habe ruiniert
cil::Einfach
olv::Olv
bete::Beth
b::b
jale::Ziehen
s::s
aqu::Hier
Quer::Ich möchte
rate::Rate
quer::Ich möchte
encontr::Finden
acabamos::Wir sind fertig.
honestas::ehrlich
llate::Verschwinde hier.
informaci::Information
despu::nach
males::Übel
recomend::Empfehlen
superbi::Superbi
energ::energ
tom::Kater
cas::Cass
manolarga::manolarga
invit::einladen
ntas::ntas
dif::Dif
ciles::einfach
tecnolog::Technolog
equivoqu::Falsch
B::B
qued::Qued
ador::Oh, Mann.
Qui::Hier
opini::opinii
bense::bense
sico::Klassiker
atenci::Attenci
ntos::ntos
coraz::kellig
podr::Podr
inversi::Investition
tambi::auch
xeres::Xeres
g::g
eyes::Augen
makeover::Überarbeitung
jaladita::Jaladita
veleta::Wetterfahne
Olvide::Vergiss es
infinidad::Unendlichkeit
estarían::würde sein
encantadísimas::Ich liebe dich
rechazo::Ablehnung
rechazado::abgelehnt
atardecer::Sonnenuntergang
recogiendo::Abholung
planchar::Bügeln
preguntó::Er fragte:
fiestas::Parteien
sobrevivido::überlebt
apetece::Ich fühle mich wie es
vuelco::umkippen
separamos::wir teilen auf
nerviosos::nervös
estropeamos::Wir vermassen
Popa::Heck
puesta::Set
Tocas::Du spielst
Sirve::Es funktioniert
desperdiciar::Abfall
tortilla::Omelett
cenando::beim Abendessen
sillas::Stühle
mandas::Du bist der Boss.
meridiano::Meridian
motivo::Motiv
sinopsis::Synopse
Proponer::Vorschlagen
fueses::Du bist gegangen.
vous::Vous
preparé::ich bereitete vor
Lástima::Schade
puestas::anziehen
deslumbrantes::blendend
Venid::Komm schon, komm schon.
tardéis::Verspätet sein
acudirá::wird kommen
Total::Insgesamt
bolsillo::Tasche
Trata::Probieren Sie es aus
amores::liebt
Corona::Krone
flores::Blumen
disculpan::Entschuldigen Sie mich.
chinita::Chinita
historias::Geschichten
vencedores::Gewinner
vencidos::abgelaufen
Pensabas::Du hast nachgedacht
Fingió::Er tat so, als hätte er
atropello::Schandtat
ayudásemos::Lasst uns helfen
colar::geschnitten
inventó::erfunden
evidente::offensichtlich
quizá::vielleicht
intentar::Versuch
empeores::Verschlechtert sich
ocupe::Achten Sie darauf
suicidado::Selbstmord
Confesó::Er gestand
Hablé::ich habe gesprochen
frigorífica::Kühlung
detuvimos::Wir haben gestoppt
peleado::stritten sich
comenté::Ich habe kommentiert
ahorcado::Henker
cuadre::Kariert
facilita::macht es einfach
suicidio::Selbstmord
cerrado::geschlossen
sugerís::Sie schlagen vor
lleve::Nehmen Sie es
normales::normal
pondría::würde setzen
puños::Manschetten
rotas::Gebrochen
calabozo::Verlies
fijé::Ich habe behoben
verdadero::echt
diesen::diesen
zanjado::Es ist abgewickelt
Creemos::Wir glauben
muriera::um zu sterben
Vendían::Sie haben verkauft
contrataron::sie/Sie haben angeheuert
pape::Papa
revisado::überarbeitet
Preferiría::Ich würde lieber
Sentía::ich fühlte
estabais::Du warst
revisé::ich überprüfte
estuvisteis::Du warst
Notasteis::Sie haben es bemerkt
acompaña::begleitet
desayunado::ich hatte gefrühstückt
abandonada::verlassen
peleó::gekämpft
olvidan::Sie vergessen,
movió::Er zog um
encargaremos::wir bestellten
enroscado::verschraubt
americana::amerikanisch
rodeo::Rodeo
enrollo::rollen
resistir::widerstehen
aprieto::reparieren
detalle::Detail
entraran::wird hereinkommen
peleando::Kämpfen
atornillada::verschraubt
conducto::Rohr
calefacción::Heizung
Cualquiera::Jeder
cantando::Gesang
reposo::Rest
recuperada::erholt
formidable::großartig
saludas::Du sagst hallo
ocurriera::zu geschehen
engañaste::Du hast betrogen
despidan::Feuer
acusar::beschuldigen
estropea::Es verdirbt
brisa::Brise
dolores::Schmerzen
garganta::Schlucht
quieta::Halten Sie die Standfesthalten
empeore::schlimmer werden
Temía::Ich hatte Angst
arrastrara::kriechen
bañábamos::Wir badeten
pagaste::Sie haben bezahlt
inculpara::belastet
resguardo::Safe
cuentes::zählen
explicaré::Ich werde es erklären.
escalfados::pochiert
requieren::erfordern
Escalfado::Pochiert
apures::Beeilen Sie sich
acelerado::Beschleunigt
remedio::heilen
apariencias::Erscheinungen
engañan::Sie täuschen
jovencita::junge Dame
encantadora::Charmeur
pega::fangen
atunes::Thunfisch
retos::Herausforderungen
rendir::aufgeben
humo::Rauch
Aparta::Wegziehen
colaboren::zusammenarbeiten
escucharon::Du hast gehört.
retiren::Stehen Sie nach unten
Llamen::Rufen Sie mich an
despierta::Wachen Sie auf
pinchar::stechen
preocupante::besorgniserregend
intoxicación::Intoxikation
refiere::bezieht sich
enseñaste::Du hast gelehrt.
tila::Linde
encinta::schwanger
pillado::Wurden erwischt
inadecuado::unzulänglich
dormitorio::Schlafzimmer
echaría::Ich würde rauswerfen
accionista::Aktionär
Hablamos::Wir haben geredet
alarma::Alarm
derecho::Recht
garantizada::Garantiert
exagerando::übertreibend
interrumpa::Unterbrechen
Siga::Gehen Sie weiter
dadas::gegeben
consecuencias::Nachwirkung
financieras::Finanzielle Mittel
regresar::gehen Sie zurück
comprometimos::Wir verpflichteten uns
comprometió::verlobt
cumpliendo::erfüllend
cumplirá::wird erfüllen
Reforzaremos::Wir werden verstärken
controlaremos::wir werden kontrollieren
pasajero::Passagier
murieron::Sie starben
lamentemos::Lass es uns bereuen
regresemos::Gehen wir zurück.
calculado::berechnet
costaría::es würde kosten
fortuito::Nebenkosten
propagar::verbreiten
marinos::Marineinfanterist
contratamos::wir haben angeheuert
cubrir::decken
entrevisté::Ich habe interviewt
matas::Du tötest
bastaba::Es war genug
registrar::Holzscheit
registrado::registriert
buscaban::Sie haben gesucht
quemo::ich verbrenne
Regresamos::Wir sind wieder da.
virada::schwerend
ángulo::Winkel
imperceptible::nicht wahrnehmbar
boludo::Boludo
Pediré::Ich werde fragen
bombillas::Glühbirnen
Conoce::Er weiß es.
Casualidad::Chance
colaborar::zusammenarbeiten
Sabrás::Du wirst es wissen.
mandará::wird Befehl
volví::Ich bin wieder da.
reza::Beten
fusilen::Schießen
estallaba::platzen
ardía::Es brannte
recuperaste::Du hast es zurück.
logré::Ich habe es geschafft
matando::Töten
falsificaste::Du hast geschmiedet.
protegido::geschützt
hijas::Töchter
comportado::benahm sich
auténtico::authentisch
pactar::eine Vereinbarung abschließen
subirá::wird hinaufgehen
jaleo::Wirbel
sobornando::Bestechung
arriar::Pacht
querrás::Du wirst es wollen
acusando::beschuldigen
tenses::angespannt
cuerda::Akkord
rompa::Brechen Sie es auf
pesimista::pessimistisch
quemó::Verbrannt
lata::Kanister
pasajeras::Passagiere
seda::Seide
talle::Größe
tul::Tüll
mangas::Ärmel
arrugar::Falte
haríamos::würden wir
expresé::Ich habe ausgedrückt
condolencias::Beileid
terrible::schrecklich
acepto::Ich akzeptiere
igualmente::gleichermaßen
cuidando::kümmert sich um
importantes::wichtig
perfección::Perfektion
jarrón::Vase
restablecido::zurücksetzen
eficientes::effizient
Daré::Ich werde geben.
mantenimiento::Wartung
remplazamos::wir ersetzen
rompimos::Wir haben uns getrennt
defendiendo::verteidigen
arrastrásemos::wir würden kriechen
lanzásemos::lasst uns starten
cometido::begangen
creería::Ich würde glauben,
atreva::Wagen
saldría::Ich würde rauskommen.
Hablará::Er wird reden.
responder::Antwort
Doña::- Dona
naturalmente::natürlich
conquistado::erobert
intenciones::Absichten
gustar::wie
mayorcita::großes Mädchen
preocupo::Ich mache mir Sorgen
sufras::leiden
planchen::Eisen
Irá::Er wird gehen.
tendréis::du sollst haben
generoso::großzügig
firmes::Firma
firmaré::Ich werde unterschreiben.
arruga::Falte
Descuide::Mach dir keine Sorgen.
guardara::wird speichern
subiste::Du bist hochgegangen.
maletín::Aktentasche
lingote::Barren
escondiera::zum Ausblenden
Este::Ost
manchado::gesprenkelt
obligación::Verpflichtung
uso::verwenden
construir::bauen
guarde::sparen
lingotes::Barren
hablaste::Du hast geredet.
conjetura::Vermutung
cases::Fälle
Encontramos::Wir haben es gefunden.
equivocado::Falsch
regalé::ich verschenkte
profundos::tief
utilizó::gebraucht
engañó::betrogen
confié::Ich vertraute
pensáramos::lasst uns nachdenken
teníais::ihr hattet
terminando::am Ende
hubieses::würdest du haben
engaño::Täuschung
aceptando::Akzeptieren
guapísima::Oh, wunderschön.
cruzar::Kreuz
comprobado::überprüft
puntual::pünktlich
merecemos::wir verdienen
dudéis::Zweifel
mandado::Gefordert
cortaba::ich schneide
suministros::Lieferungen
quiebra::Bankrott
pidieron::gefragt
desearía::Ich wünschte
liberado::freigegeben
veros::um Sie zu sehen
serte::um Sie zu sein
riqueza::Reichtum
virtud::Tugend
poderes::Mächte
otorga::Zuschüsse
legislación::Gesetzgebung
unidos::vereint
besaros::küssen Sie
socorro::Mayday
duros::schwer
embarcación::Boot
vía::Allee
abierta::öffnen
casco::Helm
sureste::Südosten
deberías::Sie sollten
detenga::Stoppen
verdes::grün
serena::Gelassen
Dejaron::Sie sind abgereist
Eterna::Ewig
sed::Hunger
caricias::Liebkosungen
dulzuras::Süßigkeiten
sabían::wusste es
Serenos::Gelassen
lago::See
quietas::Halten Sie die Standfesthalten
Difícil::Schwierig
prefiera::du bevorzugst
Salda::Komm schon, komm schon.
deuda::Schulden
procure::Suchen
devolveré::Ich kehre zurück
vuelvas::Kommen Sie zurück
lámparas::Lampen
rompieron::Sie haben sich getrennt
rompe::Brechen Sie es auf
reponer::wieder auffüllen
repuestos::ersatzteile
uniforme::sogar
inicio::Initiation
deteriorará::wird sich verschlechtern
Llevarán::Sie werden tragen.
solicitudes::-Anfragen
anotamos::Wir punkten
solicita::Anfrage
Entienda::Du verstehst
oculta::versteckt
convencerá::wird überzeugen
confiando::vertrauensvoll
nazis::Nazis
camión::Bus
firmado::signiert
trozo::Stück
pantalón::Hose
muriese::sterben
cinta::Gürtel
trataba::Ich habe versucht
levante::Osten
futura::Zukunft
armador::Reeder
aparta::Wegziehen
mentir::Lüge
utilizaste::du benutzt hast
equivocando::Falsch
matasteis::Du hast getötet.
dijéramos::wir sollten sagen,
estropeado::gebrochen
necesite::Ich brauche es.
consentir::Zustimmung
guardes::Wächter
acabarían::würde am Ende
fichado::angemeldet
cambiara::wird sich ändern
enterara::wird herausfinden
acabe::Ich bin fertig.
aparecerán::wird angezeigt
vengan::Komm schon, komm schon.
quemado::verbrannt
ciego::blind
sordo::taub
paredón::Wand
eléctrica::elektrisch
tomas::nimmt
píldoras::Pillen
aparecidas::erschien
crímenes::Verbrechen
decisiones::Entscheidungen
escoltar::Eskorte
saldrá::wird herauskommen
médica::medizinisch
ponga::Legen Sie es runter
Piensan::Sie denken
detuvieron::Sie hörten auf
paguen::bezahlen
resuelve::Lösen
maquinista::Machinist
registrando::registrieren
Aparecerán::Sie werden auftauchen
presumiendo::prahlen
culpo::Ich beschuldige es
debiste::Du hättest
débil::schwach
Supo::Er wusste es.
guardáramos::zu behalten
entendería::Ich würde verstehen,
miraras::Du wirst schauen
testaruda::stur
llevaban::Sie trugen
Quita::Steigen Sie aus
queramos::Lass es uns tun.
sean::sein
podemos::Wir können
averiguaciones::Anfragen
Preguntar::Fragen
sandalias::Sandalen
plateadas::Silber
molestaban::Sie haben sich die Mühe gemacht
llagas::Wunden
bonitas::nett
expresar::ausdrücken
investigue::untersuchen
sandalia::Sandale
resuelto::aufgelöst
entenderían::würden sie verstehen
almuerzo::Mittagessen
indiscreción::Indiskretion
procura::Versuchen
colorado::rot
bonitos::Schön
Bonitos::Schön
traiga::Bringen Sie es
refresco::Soda
escriben::sie/Sie schreiben
Camarero::Kellner
rías::lachen
urgente::exigent
desmayado::wurde ohnmächtig
alarmaros::Sie alarmieren
causa::verursachen
septicemia::Septikämie
Básicamente::Im Grunde
complicación::Komplikation
foco::Fokus
infeccioso::infektiös
fiebres::Fieber
altas::hoch
arterial::arteriell
disminuya::verringern
considerablemente::beträchtlich
dejen::Stoppen Sie es
Depende::Hängt davon ab
Recupera::Zurück
pondrá::wird setzen
morirá::Er wird sterben.
infección::Infektion
sábanas::Blätter
limpia::Sauber
pregunte::Fragen
dude::Kerl
fisgar::schnüffeln
invierte::investiert
energías::Energie
Litros::Liter
Toneladas::Tonnen
explicado::erklärt
empeño::Bemühung
Aviso::Werbung
Abrir::Öffnen
hables::Reden
ofendido::geärtert
intentaré::Ich werde es versuchen.
ausentó::Er war abwesend
entrara::wird hereinkommen
recuerde::Denken Sie daran
insignificante::unbedeutend
Fueron::Sie gingen
prisionero::gefangen
Escuchó::Er hörte
ordenó::bestellt
retire::Nehmen Sie es heraus
Contemplan::Sie betrachten
asesinado::ermordet
poderosa::mächtig
enemigos::Feinde
Incluso::Sogar
sufrió::gelitten
imágenes::Bilder
empeñaba::verpfändet
sentí::ich fühlte
sobrevalorada::überschätzt
Crea::Schaffen
ignorancia::Unwissenheit
soportar::Bär
violó::verletzt
baje::Runter
aceptará::akzeptiert
susurras::Du flüstert
oyen::Sie hören
preocupados::besorgt
pedisteis::du hast gefragt
muchas::viele
ilusiones::Illusionen
despertar::Erwachen
medicamento::Medizin
mejora::Verbesserung
imaginado::sich vorgestellt
mayores::älter
insista::bestehen
miembro::Mitglied
demostraré::Ich werde beweisen.
ocupando::besetzen
Encuentre::Finden Sie es
hablaremos::Wir werden reden.
siguió::ging weiter
averiguado::herausgefunden
enferma::übel
ayudará::Es wird helfen
mataré::Ich bringe dich um.
disculpo::Ich entschuldige mich
calme::Beruhigen Sie sich
recupere::erholen
Loco::Verrückt
creeré::Ich werde glauben
serviría::Es würde tun
empujé::ich habe geschoben
insistí::Ich habe darauf bestanden
Entiendes::Du bekommst es.
arruinado::bankrott
derrochando::Vergeuden
sermón::Predigt
dueños::Eigentümer
facilitar::erleichtern
préstamo::Darlehen
bache::Schlagloch
avale::Befürwortung
devolverías::du würdest zurückkommen
racha::Bö
ruina::Verderben
crédito::Kredit
química::Chemie
gobiernos::Regierungen
patentado::patentiert
fermentación::Gärung
obtiene::bekommt
bacterias::Bakterien
extrae::Extrakte
transforma::Transformationen
mezcla::Mischung
hidrocarburo::Kohlenwasserstoff
ecuación::Gleichung
sencilla::einfach
catalizador::Katalysator
reactivos::Reagenzien
resultado::Ergebnis
pequeño::wenig
leyendo::Lesung
barata::billig
escasez::Mangel
permanecer::verweilen
Vuelva::Kommen Sie zurück
Lleve::Nehmen Sie es
cumplido::Kompliment
ingenua::naiv
normas::Standards
traigas::Bringen Sie ein
Alto::Hoch
disparo::ich schieße
Suelte::Lassen Sie los
aleje::Wegziehen
obligue::Kraft
Traductor::Übersetzer
egresaste::Sie haben ihren Abschluss abgeschlossen.
secundaria::sekundär
viviste::Du hast gelebt
dibujé::ich habe gezeichnet
barrotes::Bars
gustaban::Sie mochten sie
aviones::Flugzeuge
preso::gefangen
fueran::zu gehen
sentían::Filz
terminé::Ich bin fertig.
mayoría::Mehrheit
materias::Fächern
aula::Klassenzimmer
sentados::Setz dich hin
copiando::Kopieren
escribía::ich habe geschrieben
pizarrón::Tafel
blancas::weiß
carpeta::Ordner
interesaba::interessiert
gustaron::Sie mochten es.
vuelan::Sie fliegen
influye::Einflüsse
experimentar::Experiment
armando::bewaffnen
cartón::Pappe
conclusiones::Meinung
dividía::geteilt
dibujar::zeichnen
historietas::Comic-Bücher
personajes::Zeichen
sentíamos::wir fühlten
robaba::Er hat gestohlen.
cansados::müde
apagados::ausgeschaltet
zombies::Zombies
boludear::Bolute
celu::Celu
proponen::vorschlagen
profes::Lehrer
ofrecía::angeboten
practicar::Praxis
olimpíada::Olympiade
materia::Angelegenheit
matemática::mathematisch
resolvía::gelöst
recitando::rezitieren
Público::Publikum
sumando::Zusammenfassend
restando::subtrahieren
multiplicando::multiplizieren
ejercicios::Übungen
procedimiento::Prozedur
pregunté::Ich habe gefragt
servía::Es war gut.
respondieron::hat geantwortet
aprobar::gutheißen
olimpíadas::Olympiade
recomendó::empfohlen
anotara::Partitur
mecánicamente::mechanisch
acertijos::Rätsel
monedas::Münzen
idénticas::identisch
pesan::Sie wiegen
levantando::anheben
balanza::Gleichgewicht
pesa::Es wiegt
caminos::Straßen
fallar::verpassen
creatividad::Kreativität
aprendíamos::wir erfuhren
aprendiendo::Lernen
pedían::sie/Sie fragten
acordé::Ich stimmte zu
distintas::anders
debates::Debatten
Elegíamos::Wir wählten
histórico::historisch
tocaba::ich spielte
traía::ich habe mitgebracht
enseñaba::ich habe unterrichtet
argumentar::argumentieren
ayudaran::wird helfen
optativo::optional
astronomía::Astronomie
palitos::Sticks
midiendo::Messen
calculáramos::zum Berechnen
diámetro::Durchmesser
libros::Bücher
elegí::ich wählte
elegimos::wir wählen
eligiera::zur Auswahl
tuviéramos::wir hatten
plantearan::wird erhöhen
desafíos::Herausforderungen
querríamos::würden wir gerne
quieran::wollen
universidad::Berufsfachschule
motivamos::wir motivieren
pasiones::Leidenschaften
descarte::verwerfen
copiar::Kopie
explorar::erforschen
despierte::Wachen Sie auf
verdaderas::wahr
Aprender::Lernen
componer::komponieren
acorde::Akkord
medicinas::Medikamente
valoración::Bewertung
pertenencias::Eigentum
recreo::Erholung
veis::Siehst du
Recordáis::Erinnern Sie sich
hablábamos::Wir haben geredet
comas::Kommas
solecito::Sonnenschein
mueves::Du bewegst dich
brazo::Arm
rascas::Kratzer
pica::Juckend
fútbol::Fußball
delantero::Angreifer
chutar::Saugen
máximo::maximal
goleador::Torschütze
campeonato::Meisterschaft
portera::Türsteherin
chula::Cool
competición::Wettbewerb
Impresionante::Beeindruckend
patadón::Kicken
balón::Ball
portería::Ziel
Gol::Ziel
gol::Ziel
choco::Tintenfisch
lala::Lala
chocote::Chocote
Érase::Es war einmal
bruja::Hexe
enamorada::Liebhaber
doncella::Maid
conseguiréis::Du bekommst es.
recaudo::erinnern
bruxa::Bruxa
escondite::Versteck
inglés::Englisch
solito::ganz allein
hormigas::Ameisen
comamos::Lasst uns essen
cansadito::Müde
lalala::Lalala
lalalala::Lalala
entrenadora::Trainer
malito::Mal
Recogeremos::Wir holen ab
trance::Trance
desafiada::herausgefordert
propuse::Ich schlug vor
llegaba::Er wollte kommen.
comía::Ich habe gegessen
bombita::Bombit
heladera::Kühlschrank
Imaginen::Vorstellen
aceptó::Er akzeptierte
Puse::Ich habe es gesagt.
directo::direkt
Escribí::Ich schrieb
azar::Chance
Arranqué::Ich habe angefangen
stalkear::Stalkear
publicado::veröffentlicht
velitas::Kerzen
Atrás::Vor
Cumple::Er macht es.
amiguera::Freund
publicaciones::Veröffentlichungen
re-gusta::Wieder mögen
confirmar::bestätigen
aparecía::tauchte auf
pintando::Malerei
bajando::Kommen runter
actualmente::zurzeit
trans::trans
egresó::Er absolvierte seinen Abschluss
ukelele::Ukulele
eco::Echo
respetuosa::respektvoll
impactadísima::sehr schockierend
elige::wählen
muestra::zeigt
fundamentalmente::grundlegend
comparación::Vergleich
transformó::transformiert
gustos::wie
imagen::Bild
Entendiendo::Ich verstehe
tolerante::nachsichtig
multicultural::multikulturell
ambiental::Umwelt
potencia::Macht
juzgué::Ich habe beurteilt
funcionó::Es funktionierte
barrera::Barriere
elija::wählen
cuestionar::Wettbewerb
challenge::Herausforderung
planeta::Planet
merecida::verdient
preguntábamos::Wir fragten
trasladan::Übertragung
encuentros::Begegnungen
traspasó::Er durchbohrt
pantallas::Bildschirme
conducta::dirigieren
etiqueta::Label
encasillar::klassifizieren
instancia::Instanz
Pregunto::Ich frage
usuario::Benutzer
Geschäfffs::Geschäfffs
Ja::Ha
Anuncie::Werben
su::seine
producto::Produkt
contáctenos::kontaktiere uns
www.OpenSubtitles.org::www.opensubtitles.org
¿::?
se::Sein
?::?
,::,
.::.
El::Die
me::mir
la::es
estropeas::verwöhnst du
muestras::Proben
te::mach du
Dejaste::Du bist gegangen
el::die
taladro::Bohrer
lo::es
¡::!
Yo::Me
!::!
Dame::Gib mir
Suelta::Lose
Olvídalo::Vergiss es
lograrás::würdest du erreichen
Te::Te
Qué::Wie
Toda::Alle
plataforma::Deck
separando::Trennen
Lo::Es
descubrimos::wir haben entdeckt
un::ein
climático::klimatisch
Cataclismo::Kataklysmus
mil::groß
La::Es
estos::diese
gases::Gase
invernadero::Gewächshaus
en::in
al::al
periodo::Zeitraum
glaciar::Gletscher
sobre::auf
congelamiento::Erfrierungen
paradoja::Paradox
producir::erzeugen
enfriamiento::abkühlend
Déjenme::Lasst mich
les::les
::::
hemisferio::Hemisphäre
templado::lauwarm
del::des
atlántico::Atlantic
y::und
Pero::Aber
derritiendo::schmelzen
los::die
polos::Stangen
alterando::ändern
flujo::fließen
Eventualmente::Schließlich
terminará::wird enden
suceda::passieren
cuándo::wenn
pueda::Dose
cien::hundert
actuamos::wir handeln
Serán::Sie werden
nuestros::unsere
nietos::Enkelkinder
quienes::wer
pagarán::wird zahlen
Y::UND
quién::wer
pagará::wird zahlen
Le::Er
Con::Winkel
Sr.::Herr
costo::Kosten
mas::mehr
Al::Al
contaminando::umweltverschmutzend
Los::Die
cascos::Helme
polares::polar
desaparecerán::wird verschwinden
...::...
Nuestra::Unsere
frágil::zerbrechlich
Debería::ich sollte
sensacionalistas::sensationalistisch
separó::separiert
tamaño::Größe
Algunas::Einige
podrían::könnte
conferencia::Konferenz
En::In
increíblemente::unglaublich
nevando::schneit
sin::ohne
precedentes::Vorfälle
ha::Hektar
causado::verursacht
caos::Unordnung
Taxi::Taxi
Me::Me
para::zum
Para::Für
entretener::unterhalten
Definitivamente::Definitiv
con::Winkel
usted::Sie
Mi::Mein
Del::Von
Leí::ich habe gelesen
las::die
marinas::Marinas
taza::Becher
Por::von
logramos::wir haben erreicht
acciones::Aktionen
eh::hä
cerré::ich schloss
boya::Boje
NOMAD::NOMADE
bajío::Bank
olas::Wellen
ajetreado::hektisch
Pégale::Schlage ihn
patéalo::tritt es
Patéalo::Tritt es
ganando::gewinnend
Hola::Hallo
esas::jene
Vas::Du gehst
Voy::ich gehe
furia::Wut
asombró::verblüfft
expertos::Experten
archipiélago::Archipel
cataclísmica::kataklysmisch
meteorólogos::Meteorologen
medido::gemessen
Acabo::Ich habe gerade
reprobó::er hat zurechtgewiesen
cálculo::Berechnung
yo::mir
calificaciones::Qualifikationen
falla::Fehler
sus::seine
discutir::diskutieren
debas::solltest du
quien::jemand
por::von
Que::Mai
él::ihm
Entró::eingetragen
decatlón::Zehnkampf
competirán::wird konkurrieren
Puedes::Du kannst
8:30::8:30 UHR
llegues::kommst du
cambiada::geändert
B.::B
porqué::warum
Porque::Weil
mi::meine
nuestro::unsere
presupuesto::Budget
odia::hasst
nos::uns selbst
recorta::abgeschnitten
Oh::Ach
Dios::Gott
enojado::wütend
desilusionado::desillusioniert
pueden::Dose
versiones::Versionen
Resolví::ich habe gelöst
examen::Prüfung
porque::da
soluciones::Lösungen
Porqué::Warum
Las::Die
debí::ich hätte haben sollen
Eso::Es
reprueba::beweist
le::ihm
discúlpame::entschuldigen Sie mich
prematuras::verfrüht
ese::das eine
arreglaremos::wir werden reparieren
Sam::Sams
podrán::wird in der Lage sein
Tu::Deine
regañará::wird schimpfen
apostar::wetten
probabilidades::Quoten
estrelle::estrelle
turbulencia::Turbulenz
menores::Minderjährige
bebidas::Getränke
Les::Les
abrochen::anschnallen
cinturones::Gürtel
mesas::Tische
vertical::nach unten
Agárralo::Schnapp es dir
Cuidado::Care
devuelves::kehrst du zurück
Se::Seien
Adiós::Auf Wiedersehen
extremo::extrem
Algunos::Einige
acreditan::akkreditieren
registrara::Register
Ah::Aah
Esa::Das eine
Veré::ich werde sehen
Esta::Das hier
improbable::unwahrscheinlich
típico::typisch
neoyorkino::neuer Yorkino
Un::Ein
embotellamiento::Stilleinfahrt
Contaminando::Kontaminieren
atmósfera::Atmosphäre
Llegaremos::Wir werden ankommen
Caminemos::Lass uns gehen
agitados::erzürnt
conquistador::Eroberer
montañas::Berge
peruanas::Peruaner
Cuál::Welches
Atahualpa::Atahualpa
Ése::Das eine
Siguiente::Folgende
qué::wie
ascendió::er stieg auf
trono::Thron
"::“
moda::Mode
grandiosa::grandios
Tú::Du
Mis::Mein
J.D.::J.D.
mostrara::wird zeigen
grandioso::grandios
detenerme::halt mich auf
competencia::Wettbewerb
Apuesto::gut aussehend
Quién::Wer
extraordinario::außergewöhnlich
perturbador::störend
deshielo::Tauwetter
polar::polar
alterar::ändern
ocurriendo::auftreten
nuestras::unsere
boyas::Bojen
registró::registriert
mandé::ich befahl
email::E-Mail senden
funcionamiento::funktionsfähig
Esto::Das
Usted::Du
predijo::vorhergesagt
sucedería::würde passieren
modelos::Modelle
remotamente::entfernt
capaces::fähig
describir::beschreiben
Excepto::Außer
suyo::seine
reconstrucción::Wiedererrichtung
pronóstico::Prognose
cercano::in der Nähe
pronosticamos::wir prognosti
Estas::Diese
Miren::Schau dir an
ustedes::ihr Jungs
Regreso::rückkehr
costera::Küsten-
playas::Strände
Centro::Zentrum
cayendo::fallend
granizo::Hagel
pelotas::Kugeln
creando::schaffend
ciclónico::zyklonisch
Pon::Setzen
canal::Kanal
debemos::wir müssen
advertencia::Verwahrung
ciclón::Zyklon
De::Von
Km::Km
/::/
inmediatamente::sofort
Podría::ich könnte
perdiste::hast du verloren
Tom::Toms
N.A.S.A.::N.A.S.A.
paleoclimático::paläoklimatisch
Emitieron::Sie haben ausgegeben
reporte::Konto
área::Bereich
cobertura::Deckung
Estos::Diese
ciclones::Zyklone
Lisa::Vokuhil
recibiendo::empfangende
voló::flog
letrero::unterschreiben
borró::ausradiert
lastimada::verletzt
muchos::viele
daños::Schaden
Tomando::Nehmen
Cúbranse::Abdeckung
lárguense::rauskommen
uno::Eins
Vete::Geh weg
Ese::Das eine
autobús::Bus
porche::Veranda
haya::Buche
desocupado::Leerlauf
unfrsen::unfrsen
Nos::uns selbst
destruyendo::zerstörend
gigantesco::riesig
Horrenda::Schrecklich
aterradora::beängstigend
devastado::trostlosen
varios::Sonstiges
aéreo::flächig
debamos::sollten wir
suspendió::suspendiert
Desafortunadamente::Leider
derribó::niedergeschlagen
aquello::Das
comencemos::lasst uns anfangen
Varsteen::Varsteen
sirven::sie dienen
ningún::nein
reporta::Berichte
circulación::Zirkulation
ártico::Arktis
tifón::Taifun
Debemos::Wir müssen
considerar::betrachten
atacar::Attacke
N.A.S.::N.A.S.
preguntamos::wir fragen
emisión::Ausstoß
Él::Er
equilibrio::ausgleichen
Todos::Alle
nadie::keine
Debido::Weil
desalinización::Entsalzung
crítica::kritisch
cual::welche
explicaría::würde erklären
convincente::überzeugend
incorporara::wird einarbeiten
predecir::voraussagen
anomalías::Abnormalitäten
continuarán::wird fortfahren
Necesitan::Sie brauchen
computadora::Computer
correcta::korrigieren
analicé::ich habe analysiert
habido::es gab
encaja::passt
Su::Sein
considera::betrachten
hemos::wir haben
Bienvenida::Willkommen
tomografía::Tomographie
disminuyó::verringert
Déjame::Lasst mich
dibujos::Zeichnungen
solía::ich habe benutzt
leérmelo::lies es mir
Debe::Muss
orgullosa::stolz
ti::Sie
Has::Du hast
continuas::kontinuierliche
Eres::sind
trate::versuchen
Llámame::Ruf mich an
obsesivo::obsessiv
Cuánto::Wie viel
han::haben
piedra::Feuerstein
he::ich habe
soportado::getragen
escala::Zwischenstopp
cierre::Verschluss
túneles::Tunnel
toda::alles
lluvia::Regen
tapó::abgedeckt
drenaje::Drainage
quedarás::würdest du bleiben
Papá::Papa
pudiera::könnte
bromear::Scherz
tomaré::ich werde nehmen
Hazme::Mach mich
Fantástico::Fantastische
residentes::Bewohner
protegiendo::schützen
abasteciendo::versorgen
temporada::Jahreszeit
Nuestro::Unsere
simulación::Simulation
Tendrá::Es wird haben
próximas::bevorstehende
u::oder
pasaría::würde bestanden
comenzar::beginnen
evacuar::evakuieren
Una::Ein
evacuación::Evakuierung
Especialmente::Vor allem
Evacuaciones::Evakuierungen
Vicepresidente::Vizeprä
Vámonos::Lass uns gehen
podían::sie könnten
museo::Museum
colección::Kollektion
animales::Tiere
disecados::seziert
mamut::Mammut
estomago::Magen
congeló::erfror
pastaba::weidete
nevar::schneit
Sobre::Am
islas::Inseln
británicas::britische
disminuido::verringert
preocuparte::Sorge
provisiones::Rückstellungen
Quédate::Bleiben
Todo::ALLES
trasbordador::Shuttle
rescate::Rettungsaktion
vendrán::werden sie kommen
nosotros::uns selbst
generador::Generator
galletas::Kekse
Estaremos::Wir werden sein
inodoro::WC
tape::Band
irlanda::Irland
visibilidad::Sichtbarkeit
Aproximadamente::Ungefähr
castillo::Schloss
Real::tatsächliche
Velocidad::Gear
viento::Horn
conductos::Kanäle
congelan::einfrieren
Presión::Druck
RPM::DREHZAHL
hélice::Helix
Aterrizaje::Landing
helicópteros::Hubschrauber
desplomaron::sie fielen
estrellaron::sie sind abgestürzt
-::-
150º::150º
sorprendentemente::erstaunlicherweise
darme::gib mir
satélite::Mond
capacidad::Kapazität
Manden::Manden
intentaremos::wir werden es versuchen
forman::forman
fines::endet
Esquiando::Ski
madrastra::Stiefmutter
Ha::Ha
llovido::regnen
central::Zentrale
atascado::festgeklebt
plataformas::Plattformen
inundadas::überschwemmt
suspendido::hängend
salidas::Ausgänge
canceladas::storniert
lucen::sie schauen
elevó::angehoben
unos::Pärchen
temíamos::wir fürchteten
creado::erstellt
aunque::obwohl
Debo::ich muss
internado::Häftling
sur::südlich
amenazar::gefährden
atorado::festgeklebt
5a::5.
avenida::Avenue
Caminando::Walking
isla::Insel
embotellamientos::Staus
Sin::Ohne
semáforos::ampeln
virtualmente::virtuell
inaccesible::nicht zugänglich
indicaciones::Anweisungen
impermeable::undurchlässig
Cállate::Halt die Klappe
ratas::Ratten
lados::Seiten
Abra::Offen
Puedo::ich kann
colectivos::Kollektive
podremos::wir können
Cálmese::Beruhige
sacaré::ich werde herausnehmen
atorada::festgeklebt
Allá::Es gibt
Dígales::Sag es ihnen
tapen::tapen
dirige::leitet
Olvidó::vergessen
pasaportes::Reisepässe
Laura::Laura
nieto::Enkel
Analizaron::Sie analysierten
enviamos::wir versenden
Pudiste::Du könntest
recrear::neu erstellen
ciclo::Zyklus
térmico::thermisch
atrayendo::anziehen
súper::super
troposfera::Troposphäre
debería::sollte
calentar::Hitze
descendiendo::absteigend
Localizamos::Wir finden
otros::andere
núcleos::Kerne
Conocemos::Wir wissen
trayectoria::Kurs
cálculos::Berechnungen
anteriores::früher
acercaban::sie näherten sich
faz::Gesicht
proyección::Projektion
Salvar::Flucht
puedan::Dose
dile::sag ihr
Malditos::Verdammt
celulares::Handys
pisos::Fußböden
inundado::awash
electricidad::Elektrizität
localizar::lokalisieren
Traté::ich habe es versucht
llamarte::ruf dich
Funciona::Es funktioniert
esa::das eine
tomaron::sie haben
fuimos::wir gingen
Haciendo::Tun
mis::meine
hombros::Schultern
Uno::Eins
papi::Vati
diles::sag es ihnen
escúchame::Hör mir zu
irte::geh weg
volverá::kommt wieder
ventisca::Schneesturm
gigantesca::riesig
congelará::wird einfrieren
Escúchame::Hör mir zu
salgas::du gehst aus
mantenerte::behalte dich
regresa::komm zurück
habías::hattest du
ahogado::ertrank
buscarte::schau nach dir
seca::Dürre
He::ICH
caminado::ging
nieve::schneien
díselo::sag ihr
tem::tem
Usando::Benutzen
corporal::korporalen
calentarte::wärm dich auf
tus::dein
rápidamente::schnell
infarto::Infarkt
administración::Verwaltung
Informaremos::Wir werden informieren
radio::Luftwellen
Buda::Buddha
cállate::halt die Klappe
básica::grundlegende
contienen::enthalten
desbalance::Ungleichgewicht
realineación::Neuausrichtung
durará::wird dauern
cubrirán::wird abdecken
totalidad::Gesamtheit
reflejarán::wird widerspiegeln
reestabilizarse::restabilisieren
promedio::durchschnittlich
aproximada::ungefähre
Ir::Gehe
inundada::überschwemmt
México::Mexiko
política::Politik
ellos::Sie
proponiendo::vorschlagen
Evacuar::evakuieren
matará::wird töten
rezar::beten
Crees::Glaubst du
patrones::Muster
ésta::letztere
contradecir::widersprechen
creará::wird erstellen
víctimas::Opfer
necesaria::notwendig
hubiesen::hätte
Basura::Müll
sugerir::vorschlagen
Seguiremos::Wir werden fortfahren
termina::endet
gasolina::Benzin
alguna::irgendein
whiskey::Whisky
Caballeros::Gentlemen
raza::züchten
humana::Mensch
crecer::wachsen
crecerán::wird wachsen
electrónica::Elektronik
matemáticas::Mathematik
estudioso::bücherlich
dígamelo::sag mir
dejaré::ich werde gehen
trabajes::arbeitest du
Hey::He
paseando::spazierend
irán::Iran
Dejan::Dejan
Escúchenme::Hör mir zu
Silencio::Still
Cuándo::Wann
evacuando::evacuando
Deberíamos::Wir sollten
Caminar::Walking
congelada::gefroren
nieva::schneien
abríguense::aufmachen
Deberías::Du solltest
morirán::werden sie sterben
congelados::gefroren
sugieres::schlagen Sie vor
profunda::tief
atrapados::gefangen
riego::Bewässerung
innecesario::nicht notwendig
Suficiente::Genug
vámonos::lass uns gehen
Moviendo::Umzug
empeorará::wird sich verschlechtern
Quédense::Bleiben
recado::Besorgung
embajada::Botschaft
Dile::Sag ihr
bendiga::segnen
Dra.::Dra.
localizamos::wir finden
Seguiré::ich werde fortfahren
cuidadote::kümmere dich um dich
cuidaba::hat sich umgesehen
Ninguno::Keiner
acabaran::werden sie enden
avance::voraus
Buena::Gute
Noticias::Nachrichten
oficiales::Offiziere
cerraron::sie haben geschlossen
frontera::Umrandung
tantos::so viele
refugiados::Flüchtlinge
norteamericanos::amerikanisch
dirigían::richteten Regie
Ésta::Letztere
Cientos::Hunderte
ingresar::eingestehen
frustración::Frustration
Han::Han
abandonado::verlassen
dirigen::sie leiten
pie::Fuß
ilegalmente::illegal
chimenea::Kamin
usado::beschäftigt
quemaremos::wir werden niederbrennen
helar::einfrieren
Iré::ich werde gehen
algunos::einige
ayudaré::ich werde helfen
pocas::wenige
expendedoras::Automaten
duraremos::wir werden dauern
chovinista::chauvinist
muchachos::Jungen
sección::Abteilung
incertidumbre::Zweifel
moviendo::bewegend
negociar::verhandeln
perdonar::verzeihen
deudas::Schulden
latinoamericanas::Latein
entraron::sie sind eingetreten
pánico::Panik
quitanieve::schneesnee
trasladado::umgezogen
ambulancias::Krankenwagen
condado::Bezirk
vete::geh weg
Debes::Du musst
calambre::Krampf
Recibes::Du erhältst
Afecta::Betrifft
enterrado::begraben
logrará::wird erreichen
alerta::warnen
emitida::ausgegeben
Exponer::entlarven
mortal::sterblich
Permanezca::Bleiben
Queme::Burnout
carreteras::Straßen
impasables::impasabeln
e::e
Muchachos::Jungs
Empaquen::Verpackungen
Caminaremos::Wir werden laufen
cuidad::Stadt
Continuemos::Lass uns weitermachen
Aislante::Insulator
aprendes::lernst du
Tus::Deine
laborales::Labour
atascados::festgeklebt
llovía::es hat geregnet
constantemente::ständig
aburrido::langweilig
trineo::Schlitten
Sostente::halten
sacaremos::wir werden herausnehmen
Jason::Jason
trataré::ich werde es versuchen
acercaré::ich werde mich nähern
aguantarte::Halte dich fest
cortes::schneidet
estante::Regal
Piensas::Du denkst
salvarte::rette dich
aferras::klammert sich
impreso::gedruckt
amanecer::Dämmerung
escrita::geschrieben
logro::Leistung
humanidad::Menschlichkeit
reírte::Lachen
ella::ihr
Muchísimas::Eine Menge
repasando::Überprüfung
datos::Daten
inútiles::nutzlos
adaptarte::anpassen
adapte::anpassen
trabajé::ich habe gearbeitet
valió::es hat sich gelohnt
uní::Uni vereinen
pálida::blass
ninguno::keine
Revisemos::Lass uns rezensieren
síntomas::Symptome
sudaba::verschwitzt
cortadas::abschneiden
infectado::infiziert
corte::Gericht
shock::Schock
dosis::Dosis
masiva::Bulk
penicilina::Penicillin
Inyectada::Injiziert
O::ODER
referencia::Grundlinie
capa::Schicht
Tomo::Tomo
infrarrojas::Infrarot
térmicas::thermisch
Recibimos::Wir erhalten
espacial::räumlich
vórtice::Wirbel
Éste::Letztere
golpeará::wird schlagen
contigo::mit dir
Adivinen::Guess
Aprovechemos::Nutzen wir
incluyéndote::einschliesslich
Encontré::ich habe gefunden
Bingo::Bingo
alacena::Schrank
Sostén::Bra
10º::10.
váyanse::geh weg
date::Datum
apresúrate::beeil dich
Ábranme::Offen für mich
medicina::Medizin
Cierren::schliessen
apague::ausschalten
Tuvimos::wir hatten
apuro::Eile
empujes::du drückst
tenerte::habt ihr
Nosotros::uns selbst
sobrevivió::überlebte
aprendamos::lass uns lernen
míos::Bergwerk
cumpliré::ich werde erfüllen
Adelante::Vorwärts
scanners::Scanner
reportan::melden
disipando::zerstreunend
Afirmativo::Bejahend
sobrevivientes::Überlebende
pasadas::nach
profundo::tief
demostrado::gezeigt
Durante::Während
estuvimos::wir waren
continuamente::ständig
podíamos::könnten wir
consumir::verbrauche
naturales::natürlich
testimonio::Zeugnis
huéspedes::Gäste
naciones::Nationen
acogieron::sie begrüßten
albergue::Herberge
agradecido::dankbar
hospitalidad::Gastfreundschaft
angustiados::beunruhigt
atrapada::gefangen
Sobrevivieron::Sie haben überlebt
probabilidad::Wahrscheinlichkeit
adversidades::Widrigkeiten
verte::wir sehen uns
Apóyanos::Unterstütze uns
conviértete::wende dich
eliminar::eliminieren
anuncios::Ankündigungen
Indica::Kennzeichnen
vicepresidente::Vizepräsident
Golpeando::Klopfen
Derrotó::Besiegt
emperador::Kaiser
Histórica::Historische
oleaje::surfen
huracanes::Wirbelstürme
helicóptero::Hubschrauber
tumor::Tumor
Inundaciones::Überschwemm
F.M.A::F.M.A
medidor::Messgerät
inundaciones::Überschwemmung
accidentes::Unfälle
Raymond::Raymond
hipotermia::Hypothermie
gripe::Grippe
envenenamiento::Vergiftung
ruso::russisch
tercer::dritte
Yo vivo::ich lebe
Yo vivo en Barcelona.::Ich wohne in Barcelona.
no te preocupes::mach dir keine Sorgen
dame::gib mir
te tengo::ich habe dich
estabas pensando::hast du gedacht
*::*
